都道府県コード,市区町村コード,都道府県名,市区町村名,人口_総数,人口_男,人口_女
00,00000,全国,全国,126146099,61349581,64796518
01,01000,北海道,北海道,5224614,2465088,2759526
01,01100,北海道,札幌市,1973395,918682,1054713
01,01101,北海道,札幌市中央区,248680,112853,135827
01,01102,北海道,札幌市北区,289323,136596,152727
01,01103,北海道,札幌市東区,265379,126023,139356
01,01104,北海道,札幌市白石区,211835,100062,111773
01,01105,北海道,札幌市豊平区,225298,104154,121144
01,01106,北海道,札幌市南区,135777,62347,73430
01,01107,北海道,札幌市西区,217040,100027,117013
01,01108,北海道,札幌市厚別区,125083,56755,68328
01,01109,北海道,札幌市手稲区,142625,66913,75712
01,01110,北海道,札幌市清田区,112355,52952,59403
01,01202,北海道,函館市,251084,113965,137119
01,01203,北海道,小樽市,111299,50136,61163
01,01204,北海道,旭川市,329306,152108,177198
01,01205,北海道,室蘭市,82383,40390,41993
01,01206,北海道,釧路市,165077,77506,87571
01,01207,北海道,帯広市,166536,79623,86913
01,01208,北海道,北見市,115480,54729,60751
01,01209,北海道,夕張市,7334,3381,3953
01,01210,北海道,岩見沢市,79306,37105,42201
01,01211,北海道,網走市,35759,18060,17699
01,01212,北海道,留萌市,20114,9649,10465
01,01213,北海道,苫小牧市,170113,83522,86591
01,01214,北海道,稚内市,33563,16651,16912
01,01215,北海道,美唄市,20413,9565,10848
01,01216,北海道,芦別市,12555,5762,6793
01,01217,北海道,江別市,121056,57523,63533
01,01218,北海道,赤平市,9698,4388,5310
01,01219,北海道,紋別市,21215,9901,11314
01,01220,北海道,士別市,17858,8416,9442
01,01221,北海道,名寄市,27282,13322,13960
01,01222,北海道,三笠市,8040,3631,4409
01,01223,北海道,根室市,24636,11762,12874
01,01224,北海道,千歳市,97950,49790,48160
01,01225,北海道,滝川市,39490,18832,20658
01,01226,北海道,砂川市,16486,7607,8879
01,01227,北海道,歌志内市,2989,1399,1590
01,01228,北海道,深川市,20039,9362,10677
01,01229,北海道,富良野市,21131,9947,11184
01,01230,北海道,登別市,46391,22146,24245
01,01231,北海道,恵庭市,70331,34088,36243
01,01233,北海道,伊達市,32826,15176,17650
01,01234,北海道,北広島市,58171,27763,30408
01,01235,北海道,石狩市,56869,27324,29545
01,01236,北海道,北斗市,44302,20542,23760
01,01303,北海道,当別町,15916,7703,8213
01,01304,北海道,新篠津村,3044,1484,1560
01,01331,北海道,松前町,6260,2805,3455
01,01332,北海道,福島町,3794,1755,2039
01,01333,北海道,知内町,4167,2060,2107
01,01334,北海道,木古内町,3832,1750,2082
01,01337,北海道,七飯町,27686,12679,15007
01,01343,北海道,鹿部町,3760,1779,1981
01,01345,北海道,森町,14338,6658,7680
01,01346,北海道,八雲町,15826,7894,7932
01,01347,北海道,長万部町,5109,2448,2661
01,01361,北海道,江差町,7428,3569,3859
01,01362,北海道,上ノ国町,4306,1965,2341
01,01363,北海道,厚沢部町,3592,1717,1875
01,01364,北海道,乙部町,3403,1538,1865
01,01367,北海道,奥尻町,2410,1280,1130
01,01370,北海道,今金町,5072,2446,2626
01,01371,北海道,せたな町,7398,3466,3932
01,01391,北海道,島牧村,1356,687,669
01,01392,北海道,寿都町,2838,1397,1441
01,01393,北海道,黒松内町,2791,1353,1438
01,01394,北海道,蘭越町,4568,2197,2371
01,01395,北海道,ニセコ町,5074,2624,2450
01,01396,北海道,真狩村,2045,1035,1010
01,01397,北海道,留寿都村,1911,971,940
01,01398,北海道,喜茂別町,2156,1112,1044
01,01399,北海道,京極町,2941,1420,1521
01,01400,北海道,倶知安町,15129,7787,7342
01,01401,北海道,共和町,5772,3047,2725
01,01402,北海道,岩内町,11648,5500,6148
01,01403,北海道,泊村,1569,784,785
01,01404,北海道,神恵内村,870,400,470
01,01405,北海道,積丹町,1831,855,976
01,01406,北海道,古平町,2745,1307,1438
01,01407,北海道,仁木町,3180,1526,1654
01,01408,北海道,余市町,18000,8342,9658
01,01409,北海道,赤井川村,1165,606,559
01,01423,北海道,南幌町,7319,3461,3858
01,01424,北海道,奈井江町,5120,2405,2715
01,01425,北海道,上砂川町,2841,1292,1549
01,01427,北海道,由仁町,4822,2302,2520
01,01428,北海道,長沼町,10289,4919,5370
01,01429,北海道,栗山町,11272,5176,6096
01,01430,北海道,月形町,3691,2185,1506
01,01431,北海道,浦臼町,1732,845,887
01,01432,北海道,新十津川町,6484,2976,3508
01,01433,北海道,妹背牛町,2693,1290,1403
01,01434,北海道,秩父別町,2329,1072,1257
01,01436,北海道,雨竜町,2389,1165,1224
01,01437,北海道,北竜町,1724,823,901
01,01438,北海道,沼田町,2909,1392,1517
01,01452,北海道,鷹栖町,6567,3105,3462
01,01453,北海道,東神楽町,10127,4702,5425
01,01454,北海道,当麻町,6319,2912,3407
01,01455,北海道,比布町,3520,1662,1858
01,01456,北海道,愛別町,2605,1215,1390
01,01457,北海道,上川町,3500,1708,1792
01,01458,北海道,東川町,8314,3877,4437
01,01459,北海道,美瑛町,9668,4495,5173
01,01460,北海道,上富良野町,10348,5363,4985
01,01461,北海道,中富良野町,4733,2260,2473
01,01462,北海道,南富良野町,2376,1228,1148
01,01463,北海道,占冠村,1306,653,653
01,01464,北海道,和寒町,3192,1497,1695
01,01465,北海道,剣淵町,2926,1425,1501
01,01468,北海道,下川町,3126,1491,1635
01,01469,北海道,美深町,4145,2038,2107
01,01470,北海道,音威子府村,706,365,341
01,01471,北海道,中川町,1528,805,723
01,01472,北海道,幌加内町,1370,681,689
01,01481,北海道,増毛町,3908,1776,2132
01,01482,北海道,小平町,2994,1431,1563
01,01483,北海道,苫前町,2936,1428,1508
01,01484,北海道,羽幌町,6548,3163,3385
01,01485,北海道,初山別村,1080,518,562
01,01486,北海道,遠別町,2520,1222,1298
01,01487,北海道,天塩町,2950,1478,1472
01,01511,北海道,猿払村,2611,1285,1326
01,01512,北海道,浜頓別町,3448,1675,1773
01,01513,北海道,中頓別町,1637,818,819
01,01514,北海道,枝幸町,7565,3600,3965
01,01516,北海道,豊富町,3974,2098,1876
01,01517,北海道,礼文町,2509,1284,1225
01,01518,北海道,利尻町,2004,994,1010
01,01519,北海道,利尻富士町,2458,1188,1270
01,01520,北海道,幌延町,2371,1290,1081
01,01543,北海道,美幌町,18697,9063,9634
01,01544,北海道,津別町,4373,2096,2277
01,01545,北海道,斜里町,11418,5672,5746
01,01546,北海道,清里町,3883,1882,2001
01,01547,北海道,小清水町,4623,2207,2416
01,01549,北海道,訓子府町,4677,2241,2436
01,01550,北海道,置戸町,2775,1281,1494
01,01552,北海道,佐呂間町,4875,2296,2579
01,01555,北海道,遠軽町,19241,9337,9904
01,01559,北海道,湧別町,8270,3947,4323
01,01560,北海道,滝上町,2421,1177,1244
01,01561,北海道,興部町,3628,1768,1860
01,01562,北海道,西興部村,1053,520,533
01,01563,北海道,雄武町,4199,1999,2200
01,01564,北海道,大空町,6775,3287,3488
01,01571,北海道,豊浦町,3821,1781,2040
01,01575,北海道,壮瞥町,2743,1285,1458
01,01578,北海道,白老町,16212,7706,8506
01,01581,北海道,厚真町,4432,2249,2183
01,01584,北海道,洞爺湖町,8442,3909,4533
01,01585,北海道,安平町,7340,3632,3708
01,01586,北海道,むかわ町,7651,3779,3872
01,01601,北海道,日高町,11279,5712,5567
01,01602,北海道,平取町,4776,2395,2381
01,01604,北海道,新冠町,5309,2603,2706
01,01607,北海道,浦河町,12074,5975,6099
01,01608,北海道,様似町,4043,1923,2120
01,01609,北海道,えりも町,4374,2230,2144
01,01610,北海道,新ひだか町,21517,10473,11044
01,01631,北海道,音更町,43576,20630,22946
01,01632,北海道,士幌町,5848,2891,2957
01,01633,北海道,上士幌町,4778,2343,2435
01,01634,北海道,鹿追町,5266,2572,2694
01,01635,北海道,新得町,5817,2900,2917
01,01636,北海道,清水町,9094,4478,4616
01,01637,北海道,芽室町,18048,8612,9436
01,01638,北海道,中札内村,3884,1880,2004
01,01639,北海道,更別村,3080,1519,1561
01,01641,北海道,大樹町,5420,2714,2706
01,01642,北海道,広尾町,6387,3096,3291
01,01643,北海道,幕別町,25766,12243,13523
01,01644,北海道,池田町,6294,2967,3327
01,01645,北海道,豊頃町,3022,1478,1544
01,01646,北海道,本別町,6618,3228,3390
01,01647,北海道,足寄町,6563,3215,3348
01,01648,北海道,陸別町,2264,1138,1126
01,01649,北海道,浦幌町,4387,2138,2249
01,01661,北海道,釧路町,19105,9101,10004
01,01662,北海道,厚岸町,8892,4173,4719
01,01663,北海道,浜中町,5507,2726,2781
01,01664,北海道,標茶町,7230,3471,3759
01,01665,北海道,弟子屈町,6955,3314,3641
01,01667,北海道,鶴居村,2558,1254,1304
01,01668,北海道,白糠町,7289,3414,3875
01,01691,北海道,別海町,14380,7286,7094
01,01692,北海道,中標津町,23010,11339,11671
01,01693,北海道,標津町,5023,2465,2558
01,01694,北海道,羅臼町,4722,2346,2376
02,02000,青森県,青森県,1237984,583402,654582
02,02201,青森県,青森市,275192,128049,147143
02,02202,青森県,弘前市,168466,77251,91215
02,02203,青森県,八戸市,223415,106818,116597
02,02204,青森県,黒石市,31946,14789,17157
02,02205,青森県,五所川原市,51415,23252,28163
02,02206,青森県,十和田市,60378,28685,31693
02,02207,青森県,三沢市,39152,19602,19550
02,02208,青森県,むつ市,54103,26104,27999
02,02209,青森県,つがる市,30934,14363,16571
02,02210,青森県,平川市,30567,14188,16379
02,02301,青森県,平内町,10126,4818,5308
02,02303,青森県,今別町,2334,1119,1215
02,02304,青森県,蓬田村,2540,1211,1329
02,02307,青森県,外ヶ浜町,5401,2527,2874
02,02321,青森県,鰺ヶ沢町,9044,4145,4899
02,02323,青森県,深浦町,7346,3397,3949
02,02343,青森県,西目屋村,1265,589,676
02,02361,青森県,藤崎町,14573,6748,7825
02,02362,青森県,大鰐町,8665,3934,4731
02,02367,青森県,田舎館村,7326,3425,3901
02,02381,青森県,板柳町,12700,5806,6894
02,02384,青森県,鶴田町,12074,5553,6521
02,02387,青森県,中泊町,9657,4432,5225
02,02401,青森県,野辺地町,12374,5776,6598
02,02402,青森県,七戸町,14556,6964,7592
02,02405,青森県,六戸町,10447,5084,5363
02,02406,青森県,横浜町,4229,2071,2158
02,02408,青森県,東北町,16428,7846,8582
02,02411,青森県,六ヶ所村,10367,5910,4457
02,02412,青森県,おいらせ町,24273,11627,12646
02,02423,青森県,大間町,4718,2375,2343
02,02424,青森県,東通村,5955,3162,2793
02,02425,青森県,風間浦村,1636,779,857
02,02426,青森県,佐井村,1788,883,905
02,02441,青森県,三戸町,9082,4288,4794
02,02442,青森県,五戸町,16042,7676,8366
02,02443,青森県,田子町,4968,2376,2592
02,02445,青森県,南部町,16809,7884,8925
02,02446,青森県,階上町,13496,6827,6669
02,02450,青森県,新郷村,2197,1069,1128
03,03000,岩手県,岩手県,1210534,582952,627582
03,03201,岩手県,盛岡市,289731,136919,152812
03,03202,岩手県,宮古市,50369,24381,25988
03,03203,岩手県,大船渡市,34728,16679,18049
03,03205,岩手県,花巻市,93193,44423,48770
03,03206,岩手県,北上市,93045,46852,46193
03,03207,岩手県,久慈市,33043,15883,17160
03,03208,岩手県,遠野市,25366,12222,13144
03,03209,岩手県,一関市,111932,54254,57678
03,03210,岩手県,陸前高田市,18262,8831,9431
03,03211,岩手県,釜石市,32078,15369,16709
03,03213,岩手県,二戸市,25513,11993,13520
03,03214,岩手県,八幡平市,24023,11509,12514
03,03215,岩手県,奥州市,112937,54840,58097
03,03216,岩手県,滝沢市,55579,27146,28433
03,03301,岩手県,雫石町,15731,7505,8226
03,03302,岩手県,葛巻町,5634,2731,2903
03,03303,岩手県,岩手町,12285,5970,6315
03,03321,岩手県,紫波町,32147,15390,16757
03,03322,岩手県,矢巾町,28056,13337,14719
03,03366,岩手県,西和賀町,5134,2380,2754
03,03381,岩手県,金ケ崎町,15535,8030,7505
03,03402,岩手県,平泉町,7252,3500,3752
03,03441,岩手県,住田町,5045,2470,2575
03,03461,岩手県,大槌町,11004,5234,5770
03,03482,岩手県,山田町,14320,6898,7422
03,03483,岩手県,岩泉町,8726,4327,4399
03,03484,岩手県,田野畑村,3059,1527,1532
03,03485,岩手県,普代村,2487,1244,1243
03,03501,岩手県,軽米町,8421,4090,4331
03,03503,岩手県,野田村,3936,1863,2073
03,03506,岩手県,九戸村,5378,2556,2822
03,03507,岩手県,洋野町,15091,7101,7990
03,03524,岩手県,一戸町,11494,5498,5996
04,04000,宮城県,宮城県,2301996,1122598,1179398
04,04100,宮城県,仙台市,1096704,531617,565087
04,04101,宮城県,仙台市青葉区,311590,150932,160658
04,04102,宮城県,仙台市宮城野区,196732,96341,100391
04,04103,宮城県,仙台市若林区,141475,69633,71842
04,04104,宮城県,仙台市太白区,234758,112968,121790
04,04105,宮城県,仙台市泉区,212149,101743,110406
04,04202,宮城県,石巻市,140151,68338,71813
04,04203,宮城県,塩竈市,52203,24877,27326
04,04205,宮城県,気仙沼市,61147,29905,31242
04,04206,宮城県,白石市,32758,15976,16782
04,04207,宮城県,名取市,78718,38567,40151
04,04208,宮城県,角田市,27976,13797,14179
04,04209,宮城県,多賀城市,62827,31359,31468
04,04211,宮城県,岩沼市,44068,21684,22384
04,04212,宮城県,登米市,76037,37163,38874
04,04213,宮城県,栗原市,64637,31134,33503
04,04214,宮城県,東松島市,39098,19089,20009
04,04215,宮城県,大崎市,127330,62429,64901
04,04216,宮城県,富谷市,51651,25091,26560
04,04301,宮城県,蔵王町,11418,5569,5849
04,04302,宮城県,七ヶ宿町,1262,620,642
04,04321,宮城県,大河原町,23571,11530,12041
04,04322,宮城県,村田町,10666,5293,5373
04,04323,宮城県,柴田町,38271,19342,18929
04,04324,宮城県,川崎町,8345,4100,4245
04,04341,宮城県,丸森町,12262,6117,6145
04,04361,宮城県,亘理町,33087,16212,16875
04,04362,宮城県,山元町,12046,5978,6068
04,04401,宮城県,松島町,13323,6414,6909
04,04404,宮城県,七ヶ浜町,18132,9024,9108
04,04406,宮城県,利府町,35182,17162,18020
04,04421,宮城県,大和町,28786,14979,13807
04,04422,宮城県,大郷町,7813,3814,3999
04,04424,宮城県,大衡村,5849,2938,2911
04,04444,宮城県,色麻町,6698,3246,3452
04,04445,宮城県,加美町,21943,10767,11176
04,04501,宮城県,涌谷町,15388,7520,7868
04,04505,宮城県,美里町,23994,11616,12378
04,04581,宮城県,女川町,6430,3351,3079
04,04606,宮城県,南三陸町,12225,5980,6245
05,05000,秋田県,秋田県,959502,452439,507063
05,05201,秋田県,秋田市,307672,145411,162261
05,05202,秋田県,能代市,49968,22932,27036
05,05203,秋田県,横手市,85555,40326,45229
05,05204,秋田県,大館市,69237,32551,36686
05,05206,秋田県,男鹿市,25154,11860,13294
05,05207,秋田県,湯沢市,42091,20115,21976
05,05209,秋田県,鹿角市,29088,13684,15404
05,05210,秋田県,由利本荘市,74707,35842,38865
05,05211,秋田県,潟上市,31720,14967,16753
05,05212,秋田県,大仙市,77657,36287,41370
05,05213,秋田県,北秋田市,30198,14157,16041
05,05214,秋田県,にかほ市,23435,11218,12217
05,05215,秋田県,仙北市,24610,11408,13202
05,05303,秋田県,小坂町,4780,2232,2548
05,05327,秋田県,上小阿仁村,2063,986,1077
05,05346,秋田県,藤里町,2896,1380,1516
05,05348,秋田県,三種町,15254,7034,8220
05,05349,秋田県,八峰町,6577,3071,3506
05,05361,秋田県,五城目町,8538,3985,4553
05,05363,秋田県,八郎潟町,5583,2534,3049
05,05366,秋田県,井川町,4566,2130,2436
05,05368,秋田県,大潟村,3011,1500,1511
05,05434,秋田県,美郷町,18613,8701,9912
05,05463,秋田県,羽後町,13825,6637,7188
05,05464,秋田県,東成瀬村,2704,1491,1213
06,06000,山形県,山形県,1068027,516438,551589
06,06201,山形県,山形市,247590,119001,128589
06,06202,山形県,米沢市,81252,40258,40994
06,06203,山形県,鶴岡市,122347,58626,63721
06,06204,山形県,酒田市,100273,47838,52435
06,06205,山形県,新庄市,34432,16446,17986
06,06206,山形県,寒河江市,40189,19529,20660
06,06207,山形県,上山市,29110,13909,15201
06,06208,山形県,村山市,22516,10937,11579
06,06209,山形県,長井市,26543,12953,13590
06,06210,山形県,天童市,62140,30222,31918
06,06211,山形県,東根市,47682,23525,24157
06,06212,山形県,尾花沢市,14971,7320,7651
06,06213,山形県,南陽市,30420,14652,15768
06,06301,山形県,山辺町,13725,6603,7122
06,06302,山形県,中山町,10746,5251,5495
06,06321,山形県,河北町,17641,8528,9113
06,06322,山形県,西川町,4956,2387,2569
06,06323,山形県,朝日町,6366,3150,3216
06,06324,山形県,大江町,7646,3797,3849
06,06341,山形県,大石田町,6577,3213,3364
06,06361,山形県,金山町,5071,2466,2605
06,06362,山形県,最上町,8080,3913,4167
06,06363,山形県,舟形町,5007,2420,2587
06,06364,山形県,真室川町,7203,3408,3795
06,06365,山形県,大蔵村,3028,1498,1530
06,06366,山形県,鮭川村,3902,1887,2015
06,06367,山形県,戸沢村,4199,1987,2212
06,06381,山形県,高畠町,22463,10950,11513
06,06382,山形県,川西町,14558,7101,7457
06,06401,山形県,小国町,7107,3573,3534
06,06402,山形県,白鷹町,12890,6357,6533
06,06403,山形県,飯豊町,6613,3214,3399
06,06426,山形県,三川町,7601,3694,3907
06,06428,山形県,庄内町,20151,9636,10515
06,06461,山形県,遊佐町,13032,6189,6843
07,07000,福島県,福島県,1833152,903864,929288
07,07201,福島県,福島市,282693,138190,144503
07,07202,福島県,会津若松市,117376,56063,61313
07,07203,福島県,郡山市,327692,161830,165862
07,07204,福島県,いわき市,332931,163525,169406
07,07205,福島県,白河市,59491,29681,29810
07,07207,福島県,須賀川市,74992,36781,38211
07,07208,福島県,喜多方市,44760,21438,23322
07,07209,福島県,相馬市,34865,17536,17329
07,07210,福島県,二本松市,53557,26305,27252
07,07211,福島県,田村市,35169,17320,17849
07,07212,福島県,南相馬市,59005,31015,27990
07,07213,福島県,伊達市,58240,28313,29927
07,07214,福島県,本宮市,30236,15018,15218
07,07301,福島県,桑折町,11459,5491,5968
07,07303,福島県,国見町,8639,4114,4525
07,07308,福島県,川俣町,12170,5986,6184
07,07322,福島県,大玉村,8900,4427,4473
07,07342,福島県,鏡石町,12318,6030,6288
07,07344,福島県,天栄村,5194,2567,2627
07,07362,福島県,下郷町,5264,2602,2662
07,07364,福島県,檜枝岐村,504,259,245
07,07367,福島県,只見町,4044,1976,2068
07,07368,福島県,南会津町,14451,7116,7335
07,07402,福島県,北塩原村,2556,1290,1266
07,07405,福島県,西会津町,5770,2789,2981
07,07407,福島県,磐梯町,3322,1604,1718
07,07408,福島県,猪苗代町,13552,6533,7019
07,07421,福島県,会津坂下町,15068,7245,7823
07,07422,福島県,湯川村,3081,1485,1596
07,07423,福島県,柳津町,3081,1501,1580
07,07444,福島県,三島町,1452,714,738
07,07445,福島県,金山町,1862,908,954
07,07446,福島県,昭和村,1246,623,623
07,07447,福島県,会津美里町,19014,9108,9906
07,07461,福島県,西郷村,20808,10636,10172
07,07464,福島県,泉崎村,6213,3061,3152
07,07465,福島県,中島村,4885,2398,2487
07,07466,福島県,矢吹町,17287,8649,8638
07,07481,福島県,棚倉町,13343,6581,6762
07,07482,福島県,矢祭町,5392,2620,2772
07,07483,福島県,塙町,8302,4079,4223
07,07484,福島県,鮫川村,3049,1531,1518
07,07501,福島県,石川町,14644,7334,7310
07,07502,福島県,玉川村,6392,3202,3190
07,07503,福島県,平田村,5826,2883,2943
07,07504,福島県,浅川町,6036,3031,3005
07,07505,福島県,古殿町,4825,2364,2461
07,07521,福島県,三春町,17018,8448,8570
07,07522,福島県,小野町,9471,4677,4794
07,07541,福島県,広野町,5412,3311,2101
07,07542,福島県,楢葉町,3710,2147,1563
07,07543,福島県,富岡町,2128,1542,586
07,07544,福島県,川内村,2044,1035,1009
07,07545,福島県,大熊町,847,754,93
07,07546,福島県,双葉町,-,-,-
07,07547,福島県,浪江町,1923,1350,573
07,07548,福島県,葛尾村,420,241,179
07,07561,福島県,新地町,7905,3945,3960
07,07564,福島県,飯舘村,1318,662,656
08,08000,茨城県,茨城県,2867009,1430976,1436033
08,08201,茨城県,水戸市,270685,132537,138148
08,08202,茨城県,日立市,174508,87126,87382
08,08203,茨城県,土浦市,142074,70935,71139
08,08204,茨城県,古河市,139344,69735,69609
08,08205,茨城県,石岡市,73061,36167,36894
08,08207,茨城県,結城市,50645,25441,25204
08,08208,茨城県,龍ケ崎市,76420,37995,38425
08,08210,茨城県,下妻市,42521,21412,21109
08,08211,茨城県,常総市,60834,30465,30369
08,08212,茨城県,常陸太田市,48602,23705,24897
08,08214,茨城県,高萩市,27699,13804,13895
08,08215,茨城県,北茨城市,41801,20760,21041
08,08216,茨城県,笠間市,73173,35783,37390
08,08217,茨城県,取手市,104524,51476,53048
08,08219,茨城県,牛久市,84651,41773,42878
08,08220,茨城県,つくば市,241656,121043,120613
08,08221,茨城県,ひたちなか市,156581,79293,77288
08,08222,茨城県,鹿嶋市,66950,34434,32516
08,08223,茨城県,潮来市,27604,13672,13932
08,08224,茨城県,守谷市,68421,34163,34258
08,08225,茨城県,常陸大宮市,39267,19392,19875
08,08226,茨城県,那珂市,53502,26047,27455
08,08227,茨城県,筑西市,100753,50018,50735
08,08228,茨城県,坂東市,52265,26593,25672
08,08229,茨城県,稲敷市,39039,19490,19549
08,08230,茨城県,かすみがうら市,40087,20341,19746
08,08231,茨城県,桜川市,39122,19359,19763
08,08232,茨城県,神栖市,95454,49407,46047
08,08233,茨城県,行方市,32185,15971,16214
08,08234,茨城県,鉾田市,45953,23376,22577
08,08235,茨城県,つくばみらい市,49872,24895,24977
08,08236,茨城県,小美玉市,48870,24591,24279
08,08302,茨城県,茨城町,31401,15563,15838
08,08309,茨城県,大洗町,15715,7789,7926
08,08310,茨城県,城里町,18097,8913,9184
08,08341,茨城県,東海村,37891,19240,18651
08,08364,茨城県,大子町,15736,7692,8044
08,08442,茨城県,美浦村,14602,7479,7123
08,08443,茨城県,阿見町,48553,24237,24316
08,08447,茨城県,河内町,8231,4051,4180
08,08521,茨城県,八千代町,21026,10991,10035
08,08542,茨城県,五霞町,8093,4066,4027
08,08546,茨城県,境町,24201,12274,11927
08,08564,茨城県,利根町,15340,7482,7858
09,09000,栃木県,栃木県,1933146,964930,968216
09,09201,栃木県,宇都宮市,518757,259616,259141
09,09202,栃木県,足利市,144746,71405,73341
09,09203,栃木県,栃木市,155549,77408,78141
09,09204,栃木県,佐野市,116228,57494,58734
09,09205,栃木県,鹿沼市,94033,46609,47424
09,09206,栃木県,日光市,77661,37823,39838
09,09208,栃木県,小山市,166666,84450,82216
09,09209,栃木県,真岡市,78190,39482,38708
09,09210,栃木県,大田原市,72087,35407,36680
09,09211,栃木県,矢板市,31165,15415,15750
09,09213,栃木県,那須塩原市,115210,57307,57903
09,09214,栃木県,さくら市,44513,23102,21411
09,09215,栃木県,那須烏山市,24875,12379,12496
09,09216,栃木県,下野市,59507,29453,30054
09,09301,栃木県,上三川町,30806,15842,14964
09,09342,栃木県,益子町,21898,10871,11027
09,09343,栃木県,茂木町,11891,5872,6019
09,09344,栃木県,市貝町,11262,5756,5506
09,09345,栃木県,芳賀町,14961,7541,7420
09,09361,栃木県,壬生町,39474,19442,20032
09,09364,栃木県,野木町,24913,12401,12512
09,09384,栃木県,塩谷町,10354,5135,5219
09,09386,栃木県,高根沢町,29229,15254,13975
09,09407,栃木県,那須町,23956,11784,12172
09,09411,栃木県,那珂川町,15215,7682,7533
10,10000,群馬県,群馬県,1939110,959411,979699
10,10201,群馬県,前橋市,332149,162298,169851
10,10202,群馬県,高崎市,372973,182646,190327
10,10203,群馬県,桐生市,106445,51392,55053
10,10204,群馬県,伊勢崎市,211850,106350,105500
10,10205,群馬県,太田市,223014,114106,108908
10,10206,群馬県,沼田市,45337,21942,23395
10,10207,群馬県,館林市,75309,37769,37540
10,10208,群馬県,渋川市,74581,36363,38218
10,10209,群馬県,藤岡市,63261,30766,32495
10,10210,群馬県,富岡市,47446,23403,24043
10,10211,群馬県,安中市,54907,26848,28059
10,10212,群馬県,みどり市,49648,24562,25086
10,10344,群馬県,榛東村,14216,7190,7026
10,10345,群馬県,吉岡町,21792,10613,11179
10,10366,群馬県,上野村,1128,573,555
10,10367,群馬県,神流町,1645,793,852
10,10382,群馬県,下仁田町,6576,3224,3352
10,10383,群馬県,南牧村,1611,762,849
10,10384,群馬県,甘楽町,12491,6175,6316
10,10421,群馬県,中之条町,15386,7498,7888
10,10424,群馬県,長野原町,5095,2529,2566
10,10425,群馬県,嬬恋村,8850,4522,4328
10,10426,群馬県,草津町,6049,3034,3015
10,10428,群馬県,高山村,3511,1745,1766
10,10429,群馬県,東吾妻町,12728,6268,6460
10,10443,群馬県,片品村,3993,1949,2044
10,10444,群馬県,川場村,3480,1593,1887
10,10448,群馬県,昭和村,6953,3455,3498
10,10449,群馬県,みなかみ町,17195,8349,8846
10,10464,群馬県,玉村町,36054,17594,18460
10,10521,群馬県,板倉町,14083,7031,7052
10,10522,群馬県,明和町,10882,5465,5417
10,10523,群馬県,千代田町,10861,5470,5391
10,10524,群馬県,大泉町,42089,22282,19807
10,10525,群馬県,邑楽町,25522,12852,12670
11,11000,埼玉県,埼玉県,7344765,3652169,3692596
11,11100,埼玉県,さいたま市,1324025,652920,671105
11,11101,埼玉県,さいたま市西区,93499,45843,47656
11,11102,埼玉県,さいたま市北区,149242,73370,75872
11,11103,埼玉県,さいたま市大宮区,117784,58338,59446
11,11104,埼玉県,さいたま市見沼区,165049,80749,84300
11,11105,埼玉県,さいたま市中央区,103269,51016,52253
11,11106,埼玉県,さいたま市桜区,98661,49764,48897
11,11107,埼玉県,さいたま市浦和区,164822,79554,85268
11,11108,埼玉県,さいたま市南区,191563,95491,96072
11,11109,埼玉県,さいたま市緑区,128321,63216,65105
11,11110,埼玉県,さいたま市岩槻区,111815,55579,56236
11,11201,埼玉県,川越市,354571,177480,177091
11,11202,埼玉県,熊谷市,194415,97087,97328
11,11203,埼玉県,川口市,594274,299238,295036
11,11206,埼玉県,行田市,78617,38736,39881
11,11207,埼玉県,秩父市,59674,29068,30606
11,11208,埼玉県,所沢市,342464,168197,174267
11,11209,埼玉県,飯能市,80361,40294,40067
11,11210,埼玉県,加須市,111623,55982,55641
11,11211,埼玉県,本庄市,78569,39216,39353
11,11212,埼玉県,東松山市,91791,46187,45604
11,11214,埼玉県,春日部市,229792,113467,116325
11,11215,埼玉県,狭山市,148699,74178,74521
11,11216,埼玉県,羽生市,52862,26142,26720
11,11217,埼玉県,鴻巣市,116828,57673,59155
11,11218,埼玉県,深谷市,141268,70200,71068
11,11219,埼玉県,上尾市,226940,112288,114652
11,11221,埼玉県,草加市,248304,125213,123091
11,11222,埼玉県,越谷市,341621,168747,172874
11,11223,埼玉県,蕨市,74283,37470,36813
11,11224,埼玉県,戸田市,140899,71388,69511
11,11225,埼玉県,入間市,145651,71803,73848
11,11227,埼玉県,朝霞市,141083,70696,70387
11,11228,埼玉県,志木市,75346,36945,38401
11,11229,埼玉県,和光市,83989,43138,40851
11,11230,埼玉県,新座市,166017,81781,84236
11,11231,埼玉県,桶川市,74748,36950,37798
11,11232,埼玉県,久喜市,150582,74607,75975
11,11233,埼玉県,北本市,65201,32214,32987
11,11234,埼玉県,八潮市,93363,47995,45368
11,11235,埼玉県,富士見市,111859,54871,56988
11,11237,埼玉県,三郷市,142145,71486,70659
11,11238,埼玉県,蓮田市,61499,30468,31031
11,11239,埼玉県,坂戸市,100275,50041,50234
11,11240,埼玉県,幸手市,50066,24979,25087
11,11241,埼玉県,鶴ヶ島市,70117,34585,35532
11,11242,埼玉県,日高市,54571,26953,27618
11,11243,埼玉県,吉川市,71979,35800,36179
11,11245,埼玉県,ふじみ野市,113597,56085,57512
11,11246,埼玉県,白岡市,52214,25764,26450
11,11301,埼玉県,伊奈町,44841,22539,22302
11,11324,埼玉県,三芳町,38434,18949,19485
11,11326,埼玉県,毛呂山町,35366,17534,17832
11,11327,埼玉県,越生町,11029,5494,5535
11,11341,埼玉県,滑川町,19732,10070,9662
11,11342,埼玉県,嵐山町,17889,8941,8948
11,11343,埼玉県,小川町,28524,14190,14334
11,11346,埼玉県,川島町,19378,9823,9555
11,11347,埼玉県,吉見町,18192,9127,9065
11,11348,埼玉県,鳩山町,13560,6556,7004
11,11349,埼玉県,ときがわ町,10540,5333,5207
11,11361,埼玉県,横瀬町,7979,3966,4013
11,11362,埼玉県,皆野町,9302,4583,4719
11,11363,埼玉県,長瀞町,6807,3321,3486
11,11365,埼玉県,小鹿野町,10928,5382,5546
11,11369,埼玉県,東秩父村,2709,1352,1357
11,11381,埼玉県,美里町,11039,5540,5499
11,11383,埼玉県,神川町,13359,6755,6604
11,11385,埼玉県,上里町,30343,15012,15331
11,11408,埼玉県,寄居町,32374,16053,16321
11,11442,埼玉県,宮代町,34147,17182,16965
11,11464,埼玉県,杉戸町,43845,21927,21918
11,11465,埼玉県,松伏町,28266,14208,14058
12,12000,千葉県,千葉県,6284480,3117987,3166493
12,12100,千葉県,千葉市,974951,481246,493705
12,12101,千葉県,千葉市中央区,211736,105766,105970
12,12102,千葉県,千葉市花見川区,177328,87280,90048
12,12103,千葉県,千葉市稲毛区,160582,80345,80237
12,12104,千葉県,千葉市若葉区,146940,73000,73940
12,12105,千葉県,千葉市緑区,129421,63121,66300
12,12106,千葉県,千葉市美浜区,148944,71734,77210
12,12202,千葉県,銚子市,58431,28248,30183
12,12203,千葉県,市川市,496676,251351,245325
12,12204,千葉県,船橋市,642907,318860,324047
12,12205,千葉県,館山市,45153,21846,23307
12,12206,千葉県,木更津市,136166,68450,67716
12,12207,千葉県,松戸市,498232,247210,251022
12,12208,千葉県,野田市,152638,76195,76443
12,12210,千葉県,茂原市,86782,42643,44139
12,12211,千葉県,成田市,132906,66231,66675
12,12212,千葉県,佐倉市,168743,82421,86322
12,12213,千葉県,東金市,58219,29251,28968
12,12215,千葉県,旭市,63745,31379,32366
12,12216,千葉県,習志野市,176197,87882,88315
12,12217,千葉県,柏市,426468,210824,215644
12,12218,千葉県,勝浦市,16927,8704,8223
12,12219,千葉県,市原市,269524,138438,131086
12,12220,千葉県,流山市,199849,98431,101418
12,12221,千葉県,八千代市,199498,97920,101578
12,12222,千葉県,我孫子市,130510,63546,66964
12,12223,千葉県,鴨川市,32116,15224,16892
12,12224,千葉県,鎌ケ谷市,109932,53592,56340
12,12225,千葉県,君津市,82206,41928,40278
12,12226,千葉県,富津市,42465,21529,20936
12,12227,千葉県,浦安市,171362,83506,87856
12,12228,千葉県,四街道市,93576,46347,47229
12,12229,千葉県,袖ケ浦市,63883,32214,31669
12,12230,千葉県,八街市,67455,34113,33342
12,12231,千葉県,印西市,102609,50574,52035
12,12232,千葉県,白井市,62441,30916,31525
12,12233,千葉県,富里市,49735,25303,24432
12,12234,千葉県,南房総市,35831,17011,18820
12,12235,千葉県,匝瑳市,35040,17251,17789
12,12236,千葉県,香取市,72356,35626,36730
12,12237,千葉県,山武市,48444,24200,24244
12,12238,千葉県,いすみ市,35544,17362,18182
12,12239,千葉県,大網白里市,48129,23549,24580
12,12322,千葉県,酒々井町,20745,10155,10590
12,12329,千葉県,栄町,20127,9869,10258
12,12342,千葉県,神崎町,5816,2938,2878
12,12347,千葉県,多古町,13735,6941,6794
12,12349,千葉県,東庄町,13228,6575,6653
12,12403,千葉県,九十九里町,14639,7203,7436
12,12409,千葉県,芝山町,7033,3474,3559
12,12410,千葉県,横芝光町,22075,10767,11308
12,12421,千葉県,一宮町,11897,5824,6073
12,12422,千葉県,睦沢町,6760,3259,3501
12,12423,千葉県,長生村,13803,6801,7002
12,12424,千葉県,白子町,10305,5115,5190
12,12426,千葉県,長柄町,6721,3295,3426
12,12427,千葉県,長南町,7198,3527,3671
12,12441,千葉県,大多喜町,8885,4307,4578
12,12443,千葉県,御宿町,6874,3260,3614
12,12463,千葉県,鋸南町,6993,3356,3637
13,13000,東京都,東京都,14047594,6898388,7149206
13,13100,東京都,特別区部,9733276,4774402,4958874
13,13101,東京都,千代田区,66680,33637,33043
13,13102,東京都,中央区,169179,80931,88248
13,13103,東京都,港区,260486,123410,137076
13,13104,東京都,新宿区,349385,174822,174563
13,13105,東京都,文京区,240069,115483,124586
13,13106,東京都,台東区,211444,108586,102858
13,13107,東京都,墨田区,272085,134787,137298
13,13108,東京都,江東区,524310,258015,266295
13,13109,東京都,品川区,422488,208688,213800
13,13110,東京都,目黒区,288088,135820,152268
13,13111,東京都,大田区,748081,372464,375617
13,13112,東京都,世田谷区,943664,445592,498072
13,13113,東京都,渋谷区,243883,117907,125976
13,13114,東京都,中野区,344880,172525,172355
13,13115,東京都,杉並区,591108,284301,306807
13,13116,東京都,豊島区,301599,151020,150579
13,13117,東京都,北区,355213,176289,178924
13,13118,東京都,荒川区,217475,107683,109792
13,13119,東京都,板橋区,584483,286179,298304
13,13120,東京都,練馬区,752608,361770,390838
13,13121,東京都,足立区,695043,347408,347635
13,13122,東京都,葛飾区,453093,225758,227335
13,13123,東京都,江戸川区,697932,351327,346605
13,13201,東京都,八王子市,579355,291307,288048
13,13202,東京都,立川市,183581,91191,92390
13,13203,東京都,武蔵野市,150149,71868,78281
13,13204,東京都,三鷹市,195391,94489,100902
13,13205,東京都,青梅市,133535,66654,66881
13,13206,東京都,府中市,262790,131468,131322
13,13207,東京都,昭島市,113949,56639,57310
13,13208,東京都,調布市,242614,117044,125570
13,13209,東京都,町田市,431079,210533,220546
13,13210,東京都,小金井市,126074,61759,64315
13,13211,東京都,小平市,198739,97507,101232
13,13212,東京都,日野市,190435,94918,95517
13,13213,東京都,東村山市,151815,73827,77988
13,13214,東京都,国分寺市,129242,62985,66257
13,13215,東京都,国立市,77130,37515,39615
13,13218,東京都,福生市,56414,28023,28391
13,13219,東京都,狛江市,84772,41043,43729
13,13220,東京都,東大和市,83901,41034,42867
13,13221,東京都,清瀬市,76208,36550,39658
13,13222,東京都,東久留米市,115271,55647,59624
13,13223,東京都,武蔵村山市,70829,35260,35569
13,13224,東京都,多摩市,146951,71611,75340
13,13225,東京都,稲城市,93151,46879,46272
13,13227,東京都,羽村市,54326,27471,26855
13,13228,東京都,あきる野市,79292,39230,40062
13,13229,東京都,西東京市,207388,100992,106396
13,13303,東京都,瑞穂町,31765,15992,15773
13,13305,東京都,日の出町,16958,8267,8691
13,13307,東京都,檜原村,2003,983,1020
13,13308,東京都,奥多摩町,4750,2389,2361
13,13361,東京都,大島町,7102,3667,3435
13,13362,東京都,利島村,327,197,130
13,13363,東京都,新島村,2441,1204,1237
13,13364,東京都,神津島村,1855,952,903
13,13381,東京都,三宅村,2273,1269,1004
13,13382,東京都,御蔵島村,323,181,142
13,13401,東京都,八丈町,7042,3534,3508
13,13402,東京都,青ヶ島村,169,102,67
13,13421,東京都,小笠原村,2929,1805,1124
14,14000,神奈川県,神奈川県,9237337,4588268,4649069
14,14100,神奈川県,横浜市,3777491,1867305,1910186
14,14101,神奈川県,横浜市鶴見区,297437,153438,143999
14,14102,神奈川県,横浜市神奈川区,247267,126011,121256
14,14103,神奈川県,横浜市西区,104935,53091,51844
14,14104,神奈川県,横浜市中区,151388,77135,74253
14,14105,神奈川県,横浜市南区,198157,98939,99218
14,14106,神奈川県,横浜市保土ケ谷区,207811,101940,105871
14,14107,神奈川県,横浜市磯子区,166731,82061,84670
14,14108,神奈川県,横浜市金沢区,198939,97016,101923
14,14109,神奈川県,横浜市港北区,358530,179150,179380
14,14110,神奈川県,横浜市戸塚区,283709,138309,145400
14,14111,神奈川県,横浜市港南区,215248,105015,110233
14,14112,神奈川県,横浜市旭区,245174,118260,126914
14,14113,神奈川県,横浜市緑区,183082,90168,92914
14,14114,神奈川県,横浜市瀬谷区,122623,59355,63268
14,14115,神奈川県,横浜市栄区,120194,58513,61681
14,14116,神奈川県,横浜市泉区,152378,73934,78444
14,14117,神奈川県,横浜市青葉区,310756,150351,160405
14,14118,神奈川県,横浜市都筑区,213132,104619,108513
14,14130,神奈川県,川崎市,1538262,775772,762490
14,14131,神奈川県,川崎市川崎区,232965,125091,107874
14,14132,神奈川県,川崎市幸区,171119,86705,84414
14,14133,神奈川県,川崎市中原区,263683,133883,129800
14,14134,神奈川県,川崎市高津区,234328,116338,117990
14,14135,神奈川県,川崎市多摩区,221734,112978,108756
14,14136,神奈川県,川崎市宮前区,233728,113386,120342
14,14137,神奈川県,川崎市麻生区,180705,87391,93314
14,14150,神奈川県,相模原市,725493,362193,363300
14,14151,神奈川県,相模原市緑区,170207,85615,84592
14,14152,神奈川県,相模原市中央区,273875,137167,136708
14,14153,神奈川県,相模原市南区,281411,139411,142000
14,14201,神奈川県,横須賀市,388078,193513,194565
14,14203,神奈川県,平塚市,258422,129056,129366
14,14204,神奈川県,鎌倉市,172710,81097,91613
14,14205,神奈川県,藤沢市,436905,215596,221309
14,14206,神奈川県,小田原市,188856,91321,97535
14,14207,神奈川県,茅ヶ崎市,242389,117608,124781
14,14208,神奈川県,逗子市,57060,26719,30341
14,14210,神奈川県,三浦市,42069,20142,21927
14,14211,神奈川県,秦野市,162439,82134,80305
14,14212,神奈川県,厚木市,223705,115343,108362
14,14213,神奈川県,大和市,239169,119582,119587
14,14214,神奈川県,伊勢原市,101780,51486,50294
14,14215,神奈川県,海老名市,136516,68631,67885
14,14216,神奈川県,座間市,132325,66001,66324
14,14217,神奈川県,南足柄市,40841,20000,20841
14,14218,神奈川県,綾瀬市,83913,42581,41332
14,14301,神奈川県,葉山町,31665,14914,16751
14,14321,神奈川県,寒川町,48348,24466,23882
14,14341,神奈川県,大磯町,31634,15411,16223
14,14342,神奈川県,二宮町,27564,13285,14279
14,14361,神奈川県,中井町,9300,4664,4636
14,14362,神奈川県,大井町,17129,8437,8692
14,14363,神奈川県,松田町,10836,5404,5432
14,14364,神奈川県,山北町,9761,4826,4935
14,14366,神奈川県,開成町,18329,8911,9418
14,14382,神奈川県,箱根町,11293,5423,5870
14,14383,神奈川県,真鶴町,6722,3124,3598
14,14384,神奈川県,湯河原町,23426,10884,12542
14,14401,神奈川県,愛川町,39869,20883,18986
14,14402,神奈川県,清川村,3038,1556,1482
15,15000,新潟県,新潟県,2201272,1068670,1132602
15,15100,新潟県,新潟市,789275,379741,409534
15,15101,新潟県,新潟市北区,72804,35490,37314
15,15102,新潟県,新潟市東区,134446,64388,70058
15,15103,新潟県,新潟市中央区,180345,86046,94299
15,15104,新潟県,新潟市江南区,67972,32940,35032
15,15105,新潟県,新潟市秋葉区,75069,36016,39053
15,15106,新潟県,新潟市南区,43437,20977,22460
15,15107,新潟県,新潟市西区,160656,77653,83003
15,15108,新潟県,新潟市西蒲区,54546,26231,28315
15,15202,新潟県,長岡市,266936,131011,135925
15,15204,新潟県,三条市,94642,45815,48827
15,15205,新潟県,柏崎市,81526,40556,40970
15,15206,新潟県,新発田市,94927,45963,48964
15,15208,新潟県,小千谷市,34096,16830,17266
15,15209,新潟県,加茂市,25441,12406,13035
15,15210,新潟県,十日町市,49820,24339,25481
15,15211,新潟県,見附市,39237,19050,20187
15,15212,新潟県,村上市,57418,27474,29944
15,15213,新潟県,燕市,77201,37629,39572
15,15216,新潟県,糸魚川市,40765,20068,20697
15,15217,新潟県,妙高市,30383,14740,15643
15,15218,新潟県,五泉市,47625,22890,24735
15,15222,新潟県,上越市,188047,91929,96118
15,15223,新潟県,阿賀野市,40696,19570,21126
15,15224,新潟県,佐渡市,51492,24881,26611
15,15225,新潟県,魚沼市,34483,16802,17681
15,15226,新潟県,南魚沼市,54851,26777,28074
15,15227,新潟県,胎内市,28509,13959,14550
15,15307,新潟県,聖籠町,14259,7172,7087
15,15342,新潟県,弥彦村,7705,3733,3972
15,15361,新潟県,田上町,11227,5395,5832
15,15385,新潟県,阿賀町,9965,4825,5140
15,15405,新潟県,出雲崎町,4113,1978,2135
15,15461,新潟県,湯沢町,7767,3946,3821
15,15482,新潟県,津南町,8989,4322,4667
15,15504,新潟県,刈羽村,4380,2244,2136
15,15581,新潟県,関川村,5144,2444,2700
15,15586,新潟県,粟島浦村,353,181,172
16,16000,富山県,富山県,1034814,502637,532177
16,16201,富山県,富山市,413938,202281,211657
16,16202,富山県,高岡市,166393,80482,85911
16,16204,富山県,魚津市,40535,19729,20806
16,16205,富山県,氷見市,43950,20883,23067
16,16206,富山県,滑川市,32349,15750,16599
16,16207,富山県,黒部市,39638,19514,20124
16,16208,富山県,砺波市,48154,23419,24735
16,16209,富山県,小矢部市,28983,13991,14992
16,16210,富山県,南砺市,47937,22940,24997
16,16211,富山県,射水市,90742,44253,46489
16,16321,富山県,舟橋村,3132,1521,1611
16,16322,富山県,上市町,19351,9255,10096
16,16323,富山県,立山町,24792,12002,12790
16,16342,富山県,入善町,23839,11385,12454
16,16343,富山県,朝日町,11081,5232,5849
17,17000,石川県,石川県,1132526,549771,582755
17,17201,石川県,金沢市,463254,224549,238705
17,17202,石川県,七尾市,50300,23970,26330
17,17203,石川県,小松市,106216,52182,54034
17,17204,石川県,輪島市,24608,11714,12894
17,17205,石川県,珠洲市,12929,5933,6996
17,17206,石川県,加賀市,63220,29939,33281
17,17207,石川県,羽咋市,20407,9669,10738
17,17209,石川県,かほく市,34889,16875,18014
17,17210,石川県,白山市,110408,53670,56738
17,17211,石川県,能美市,48523,24129,24394
17,17212,石川県,野々市市,57238,29550,27688
17,17324,石川県,川北町,6135,3030,3105
17,17361,石川県,津幡町,36957,18044,18913
17,17365,石川県,内灘町,26574,12774,13800
17,17384,石川県,志賀町,18630,8878,9752
17,17386,石川県,宝達志水町,12121,5718,6403
17,17407,石川県,中能登町,16540,7977,8563
17,17461,石川県,穴水町,7890,3793,4097
17,17463,石川県,能登町,15687,7377,8310
18,18000,福井県,福井県,766863,373973,392890
18,18201,福井県,福井市,262328,127867,134461
18,18202,福井県,敦賀市,64264,31785,32479
18,18204,福井県,小浜市,28991,14317,14674
18,18205,福井県,大野市,31286,14997,16289
18,18206,福井県,勝山市,22150,10581,11569
18,18207,福井県,鯖江市,68302,33323,34979
18,18208,福井県,あわら市,27524,13067,14457
18,18209,福井県,越前市,80611,39657,40954
18,18210,福井県,坂井市,88481,42719,45762
18,18322,福井県,永平寺町,18965,9231,9734
18,18382,福井県,池田町,2423,1196,1227
18,18404,福井県,南越前町,10002,4804,5198
18,18423,福井県,越前町,20118,9725,10393
18,18442,福井県,美浜町,9179,4610,4569
18,18481,福井県,高浜町,10326,5424,4902
18,18483,福井県,おおい町,7910,3968,3942
18,18501,福井県,若狭町,14003,6702,7301
19,19000,山梨県,山梨県,809974,397309,412665
19,19201,山梨県,甲府市,189591,92850,96741
19,19202,山梨県,富士吉田市,46530,22645,23885
19,19204,山梨県,都留市,31016,14949,16067
19,19205,山梨県,山梨市,33435,16081,17354
19,19206,山梨県,大月市,22512,10924,11588
19,19207,山梨県,韮崎市,29067,14500,14567
19,19208,山梨県,南アルプス市,69459,34164,35295
19,19209,山梨県,北杜市,44053,21492,22561
19,19210,山梨県,甲斐市,75313,37238,38075
19,19211,山梨県,笛吹市,66947,32447,34500
19,19212,山梨県,上野原市,22669,11331,11338
19,19213,山梨県,甲州市,29237,14068,15169
19,19214,山梨県,中央市,31216,15509,15707
19,19346,山梨県,市川三郷町,14700,7164,7536
19,19364,山梨県,早川町,1098,627,471
19,19365,山梨県,身延町,10663,5226,5437
19,19366,山梨県,南部町,7156,3496,3660
19,19368,山梨県,富士川町,14219,6848,7371
19,19384,山梨県,昭和町,20909,10451,10458
19,19422,山梨県,道志村,1607,811,796
19,19423,山梨県,西桂町,4041,1947,2094
19,19424,山梨県,忍野村,9237,5137,4100
19,19425,山梨県,山中湖村,5179,2559,2620
19,19429,山梨県,鳴沢村,2824,1390,1434
19,19430,山梨県,富士河口湖町,26082,12839,13243
19,19442,山梨県,小菅村,684,344,340
19,19443,山梨県,丹波山村,530,272,258
20,20000,長野県,長野県,2048011,1000389,1047622
20,20201,長野県,長野市,372760,181284,191476
20,20202,長野県,松本市,241145,118271,122874
20,20203,長野県,上田市,154055,75365,78690
20,20204,長野県,岡谷市,47790,23213,24577
20,20205,長野県,飯田市,98164,47280,50884
20,20206,長野県,諏訪市,48729,23809,24920
20,20207,長野県,須坂市,49559,24324,25235
20,20208,長野県,小諸市,40991,19972,21019
20,20209,長野県,伊那市,66125,32437,33688
20,20210,長野県,駒ヶ根市,32202,15729,16473
20,20211,長野県,中野市,42338,20552,21786
20,20212,長野県,大町市,26029,12594,13435
20,20213,長野県,飯山市,19539,9498,10041
20,20214,長野県,茅野市,56400,28241,28159
20,20215,長野県,塩尻市,67241,33620,33621
20,20217,長野県,佐久市,98199,48035,50164
20,20218,長野県,千曲市,58852,28404,30448
20,20219,長野県,東御市,30122,14776,15346
20,20220,長野県,安曇野市,94222,45398,48824
20,20303,長野県,小海町,4353,2140,2213
20,20304,長野県,川上村,4344,2591,1753
20,20305,長野県,南牧村,3242,1807,1435
20,20306,長野県,南相木村,962,473,489
20,20307,長野県,北相木村,752,378,374
20,20309,長野県,佐久穂町,10218,4966,5252
20,20321,長野県,軽井沢町,19188,9178,10010
20,20323,長野県,御代田町,15555,7703,7852
20,20324,長野県,立科町,6612,3328,3284
20,20349,長野県,青木村,4121,1976,2145
20,20350,長野県,長和町,5600,2774,2826
20,20361,長野県,下諏訪町,19155,9238,9917
20,20362,長野県,富士見町,14084,6839,7245
20,20363,長野県,原村,7680,3771,3909
20,20382,長野県,辰野町,18555,9016,9539
20,20383,長野県,箕輪町,24989,12511,12478
20,20384,長野県,飯島町,9004,4392,4612
20,20385,長野県,南箕輪村,15797,7851,7946
20,20386,長野県,中川村,4651,2189,2462
20,20388,長野県,宮田村,8569,4162,4407
20,20402,長野県,松川町,12530,6069,6461
20,20403,長野県,高森町,12811,6153,6658
20,20404,長野県,阿南町,4299,2071,2228
20,20407,長野県,阿智村,6068,2894,3174
20,20409,長野県,平谷村,387,192,195
20,20410,長野県,根羽村,852,411,441
20,20411,長野県,下條村,3545,1709,1836
20,20412,長野県,売木村,548,252,296
20,20413,長野県,天龍村,1178,558,620
20,20414,長野県,泰阜村,1542,726,816
20,20415,長野県,喬木村,5973,2908,3065
20,20416,長野県,豊丘村,6426,3185,3241
20,20417,長野県,大鹿村,1023,539,484
20,20422,長野県,上松町,4131,2044,2087
20,20423,長野県,南木曽町,3915,1896,2019
20,20425,長野県,木祖村,2692,1235,1457
20,20429,長野県,王滝村,715,340,375
20,20430,長野県,大桑村,3439,1682,1757
20,20432,長野県,木曽町,10584,5155,5429
20,20446,長野県,麻績村,2593,1219,1374
20,20448,長野県,生坂村,1639,818,821
20,20450,長野県,山形村,8400,4103,4297
20,20451,長野県,朝日村,4279,2110,2169
20,20452,長野県,筑北村,4149,2046,2103
20,20481,長野県,池田町,9382,4552,4830
20,20482,長野県,松川村,9599,4605,4994
20,20485,長野県,白馬村,8575,4257,4318
20,20486,長野県,小谷村,2647,1367,1280
20,20521,長野県,坂城町,14004,6909,7095
20,20541,長野県,小布施町,10660,5122,5538
20,20543,長野県,高山村,6617,3242,3375
20,20561,長野県,山ノ内町,11352,5519,5833
20,20562,長野県,木島平村,4375,2114,2261
20,20563,長野県,野沢温泉村,3279,1571,1708
20,20583,長野県,信濃町,7739,3812,3927
20,20588,長野県,小川村,2215,1100,1115
20,20590,長野県,飯綱町,10296,5019,5277
20,20602,長野県,栄村,1660,800,860
21,21000,岐阜県,岐阜県,1978742,960436,1018306
21,21201,岐阜県,岐阜市,402557,191679,210878
21,21202,岐阜県,大垣市,158286,76994,81292
21,21203,岐阜県,高山市,84419,40483,43936
21,21204,岐阜県,多治見市,106732,51437,55295
21,21205,岐阜県,関市,85283,41657,43626
21,21206,岐阜県,中津川市,76570,37414,39156
21,21207,岐阜県,美濃市,19247,9289,9958
21,21208,岐阜県,瑞浪市,37150,18156,18994
21,21209,岐阜県,羽島市,65649,32303,33346
21,21210,岐阜県,恵那市,47774,23138,24636
21,21211,岐阜県,美濃加茂市,56689,28141,28548
21,21212,岐阜県,土岐市,55348,26803,28545
21,21213,岐阜県,各務原市,144521,71220,73301
21,21214,岐阜県,可児市,99968,49202,50766
21,21215,岐阜県,山県市,25280,12184,13096
21,21216,岐阜県,瑞穂市,56388,28105,28283
21,21217,岐阜県,飛騨市,22538,10860,11678
21,21218,岐阜県,本巣市,32928,15936,16992
21,21219,岐阜県,郡上市,38997,19051,19946
21,21220,岐阜県,下呂市,30428,14471,15957
21,21221,岐阜県,海津市,32735,16045,16690
21,21302,岐阜県,岐南町,25881,12664,13217
21,21303,岐阜県,笠松町,22208,10513,11695
21,21341,岐阜県,養老町,26882,13116,13766
21,21361,岐阜県,垂井町,26402,12985,13417
21,21362,岐阜県,関ケ原町,6610,3202,3408
21,21381,岐阜県,神戸町,18585,9099,9486
21,21382,岐阜県,輪之内町,9654,4807,4847
21,21383,岐阜県,安八町,14355,7036,7319
21,21401,岐阜県,揖斐川町,19529,9366,10163
21,21403,岐阜県,大野町,22041,10778,11263
21,21404,岐阜県,池田町,23360,11425,11935
21,21421,岐阜県,北方町,18139,8652,9487
21,21501,岐阜県,坂祝町,8071,4168,3903
21,21502,岐阜県,富加町,5626,2705,2921
21,21503,岐阜県,川辺町,9860,4865,4995
21,21504,岐阜県,七宗町,3402,1608,1794
21,21505,岐阜県,八百津町,10195,4905,5290
21,21506,岐阜県,白川町,7412,3485,3927
21,21507,岐阜県,東白川村,2016,964,1052
21,21521,岐阜県,御嵩町,17516,8770,8746
21,21604,岐阜県,白川村,1511,755,756
22,22000,静岡県,静岡県,3633202,1791118,1842084
22,22100,静岡県,静岡市,693389,337812,355577
22,22101,静岡県,静岡市葵区,249297,119984,129313
22,22102,静岡県,静岡市駿河区,213026,105146,107880
22,22103,静岡県,静岡市清水区,231066,112682,118384
22,22130,静岡県,浜松市,790718,392900,397818
22,22131,静岡県,浜松市中区,235240,117377,117863
22,22132,静岡県,浜松市東区,129356,64357,64999
22,22133,静岡県,浜松市西区,108160,53482,54678
22,22134,静岡県,浜松市南区,99769,50016,49753
22,22135,静岡県,浜松市北区,92688,45656,47032
22,22136,静岡県,浜松市浜北区,98779,49066,49713
22,22137,静岡県,浜松市天竜区,26726,12946,13780
22,22203,静岡県,沼津市,189386,93046,96340
22,22205,静岡県,熱海市,34208,15438,18770
22,22206,静岡県,三島市,107783,52421,55362
22,22207,静岡県,富士宮市,128105,63364,64741
22,22208,静岡県,伊東市,65491,30668,34823
22,22209,静岡県,島田市,95719,46725,48994
22,22210,静岡県,富士市,245392,120694,124698
22,22211,静岡県,磐田市,166672,83980,82692
22,22212,静岡県,焼津市,136845,66952,69893
22,22213,静岡県,掛川市,114954,57655,57299
22,22214,静岡県,藤枝市,141342,68793,72549
22,22215,静岡県,御殿場市,86614,44454,42160
22,22216,静岡県,袋井市,87864,44534,43330
22,22219,静岡県,下田市,20183,9675,10508
22,22220,静岡県,裾野市,50911,25773,25138
22,22221,静岡県,湖西市,57885,29625,28260
22,22222,静岡県,伊豆市,28190,13342,14848
22,22223,静岡県,御前崎市,31103,15803,15300
22,22224,静岡県,菊川市,47789,24173,23616
22,22225,静岡県,伊豆の国市,46804,22459,24345
22,22226,静岡県,牧之原市,43502,21414,22088
22,22301,静岡県,東伊豆町,11488,5440,6048
22,22302,静岡県,河津町,6870,3317,3553
22,22304,静岡県,南伊豆町,7877,3722,4155
22,22305,静岡県,松崎町,6038,2837,3201
22,22306,静岡県,西伊豆町,7090,3352,3738
22,22325,静岡県,函南町,36794,17916,18878
22,22341,静岡県,清水町,31710,15388,16322
22,22342,静岡県,長泉町,43336,21434,21902
22,22344,静岡県,小山町,18568,9845,8723
22,22424,静岡県,吉田町,28919,14413,14506
22,22429,静岡県,川根本町,6206,3055,3151
22,22461,静岡県,森町,17457,8699,8758
23,23000,愛知県,愛知県,7542415,3761502,3780913
23,23100,愛知県,名古屋市,2332176,1146669,1185507
23,23101,愛知県,名古屋市千種区,165245,80239,85006
23,23102,愛知県,名古屋市東区,84392,40483,43909
23,23103,愛知県,名古屋市北区,162956,79185,83771
23,23104,愛知県,名古屋市西区,151082,74787,76295
23,23105,愛知県,名古屋市中村区,138599,70094,68505
23,23106,愛知県,名古屋市中区,93100,46086,47014
23,23107,愛知県,名古屋市昭和区,107599,52961,54638
23,23108,愛知県,名古屋市瑞穂区,108332,51984,56348
23,23109,愛知県,名古屋市熱田区,66957,33400,33557
23,23110,愛知県,名古屋市中川区,220728,108929,111799
23,23111,愛知県,名古屋市港区,143715,72197,71518
23,23112,愛知県,名古屋市南区,134510,68355,66155
23,23113,愛知県,名古屋市守山区,176587,86087,90500
23,23114,愛知県,名古屋市緑区,248802,121993,126809
23,23115,愛知県,名古屋市名東区,164755,78867,85888
23,23116,愛知県,名古屋市天白区,164817,81022,83795
23,23201,愛知県,豊橋市,371920,186160,185760
23,23202,愛知県,岡崎市,384654,193719,190935
23,23203,愛知県,一宮市,380073,184934,195139
23,23204,愛知県,瀬戸市,127792,62586,65206
23,23205,愛知県,半田市,117884,59364,58520
23,23206,愛知県,春日井市,308681,152320,156361
23,23207,愛知県,豊川市,184661,91964,92697
23,23208,愛知県,津島市,60942,29664,31278
23,23209,愛知県,碧南市,72458,37286,35172
23,23210,愛知県,刈谷市,153834,80203,73631
23,23211,愛知県,豊田市,422330,220716,201614
23,23212,愛知県,安城市,187990,96093,91897
23,23213,愛知県,西尾市,169046,85594,83452
23,23214,愛知県,蒲郡市,79538,39336,40202
23,23215,愛知県,犬山市,73090,36240,36850
23,23216,愛知県,常滑市,58710,28575,30135
23,23217,愛知県,江南市,98255,47920,50335
23,23219,愛知県,小牧市,148831,75290,73541
23,23220,愛知県,稲沢市,134751,66415,68336
23,23221,愛知県,新城市,44355,22002,22353
23,23222,愛知県,東海市,113787,59158,54629
23,23223,愛知県,大府市,93123,47374,45749
23,23224,愛知県,知多市,84364,42346,42018
23,23225,愛知県,知立市,72193,38127,34066
23,23226,愛知県,尾張旭市,83144,40453,42691
23,23227,愛知県,高浜市,46106,23790,22316
23,23228,愛知県,岩倉市,47983,23866,24117
23,23229,愛知県,豊明市,69295,35061,34234
23,23230,愛知県,日進市,91520,45149,46371
23,23231,愛知県,田原市,59360,30138,29222
23,23232,愛知県,愛西市,60829,29536,31293
23,23233,愛知県,清須市,67352,33520,33832
23,23234,愛知県,北名古屋市,86385,43041,43344
23,23235,愛知県,弥富市,43025,21465,21560
23,23236,愛知県,みよし市,61952,32105,29847
23,23237,愛知県,あま市,86126,42561,43565
23,23238,愛知県,長久手市,60162,29144,31018
23,23302,愛知県,東郷町,43903,21931,21972
23,23342,愛知県,豊山町,15613,7937,7676
23,23361,愛知県,大口町,24305,12261,12044
23,23362,愛知県,扶桑町,34133,16839,17294
23,23424,愛知県,大治町,32399,16304,16095
23,23425,愛知県,蟹江町,37338,18428,18910
23,23427,愛知県,飛島村,4575,2251,2324
23,23441,愛知県,阿久比町,28383,13965,14418
23,23442,愛知県,東浦町,49596,24726,24870
23,23445,愛知県,南知多町,16617,8079,8538
23,23446,愛知県,美浜町,22496,11213,11283
23,23447,愛知県,武豊町,43535,22116,21419
23,23501,愛知県,幸田町,42449,21504,20945
23,23561,愛知県,設楽町,4437,2165,2272
23,23562,愛知県,東栄町,2942,1417,1525
23,23563,愛知県,豊根村,1017,482,535
24,24000,三重県,三重県,1770254,864475,905779
24,24201,三重県,津市,274537,133537,141000
24,24202,三重県,四日市市,305424,152669,152755
24,24203,三重県,伊勢市,122765,58161,64604
24,24204,三重県,松阪市,159145,76360,82785
24,24205,三重県,桑名市,138613,68084,70529
24,24207,三重県,鈴鹿市,195670,97350,98320
24,24208,三重県,名張市,76387,36853,39534
24,24209,三重県,尾鷲市,16252,7562,8690
24,24210,三重県,亀山市,49835,25161,24674
24,24211,三重県,鳥羽市,17525,8255,9270
24,24212,三重県,熊野市,15965,7384,8581
24,24214,三重県,いなべ市,44973,23106,21867
24,24215,三重県,志摩市,46057,21206,24851
24,24216,三重県,伊賀市,88766,43446,45320
24,24303,三重県,木曽岬町,6023,3032,2991
24,24324,三重県,東員町,25784,12614,13170
24,24341,三重県,菰野町,40559,19868,20691
24,24343,三重県,朝日町,11021,5488,5533
24,24344,三重県,川越町,15123,7798,7325
24,24441,三重県,多気町,14021,6753,7268
24,24442,三重県,明和町,22445,10666,11779
24,24443,三重県,大台町,8668,4103,4565
24,24461,三重県,玉城町,15041,7184,7857
24,24470,三重県,度会町,7847,3798,4049
24,24471,三重県,大紀町,7815,3652,4163
24,24472,三重県,南伊勢町,10989,5095,5894
24,24543,三重県,紀北町,14604,6758,7846
24,24561,三重県,御浜町,8079,3765,4314
24,24562,三重県,紀宝町,10321,4767,5554
25,25000,滋賀県,滋賀県,1413610,697429,716181
25,25201,滋賀県,大津市,345070,166673,178397
25,25202,滋賀県,彦根市,113647,56492,57155
25,25203,滋賀県,長浜市,113636,55406,58230
25,25204,滋賀県,近江八幡市,81122,39676,41446
25,25206,滋賀県,草津市,143913,72646,71267
25,25207,滋賀県,守山市,83236,40872,42364
25,25208,滋賀県,栗東市,68820,34110,34710
25,25209,滋賀県,甲賀市,88358,44014,44344
25,25210,滋賀県,野洲市,50513,25121,25392
25,25211,滋賀県,湖南市,54460,28168,26292
25,25212,滋賀県,高島市,46377,22762,23615
25,25213,滋賀県,東近江市,112819,56296,56523
25,25214,滋賀県,米原市,37225,18051,19174
25,25383,滋賀県,日野町,20964,10555,10409
25,25384,滋賀県,竜王町,11789,6192,5597
25,25425,滋賀県,愛荘町,20893,10373,10520
25,25441,滋賀県,豊郷町,7132,3458,3674
25,25442,滋賀県,甲良町,6362,3060,3302
25,25443,滋賀県,多賀町,7274,3504,3770
26,26000,京都府,京都府,2578087,1231468,1346619
26,26100,京都府,京都市,1463723,692279,771444
26,26101,京都府,京都市北区,117165,55738,61427
26,26102,京都府,京都市上京区,83832,38518,45314
26,26103,京都府,京都市左京区,166039,79943,86096
26,26104,京都府,京都市中京区,110488,50549,59939
26,26105,京都府,京都市東山区,36602,16078,20524
26,26106,京都府,京都市下京区,82784,38121,44663
26,26107,京都府,京都市南区,101970,50617,51353
26,26108,京都府,京都市右京区,202047,94873,107174
26,26109,京都府,京都市伏見区,277858,133097,144761
26,26110,京都府,京都市山科区,135101,63532,71569
26,26111,京都府,京都市西京区,149837,71213,78624
26,26201,京都府,福知山市,77306,38504,38802
26,26202,京都府,舞鶴市,80336,40244,40092
26,26203,京都府,綾部市,31846,15239,16607
26,26204,京都府,宇治市,179630,86301,93329
26,26205,京都府,宮津市,16758,7942,8816
26,26206,京都府,亀岡市,86174,41654,44520
26,26207,京都府,城陽市,74607,35864,38743
26,26208,京都府,向日市,56859,27119,29740
26,26209,京都府,長岡京市,80608,38793,41815
26,26210,京都府,八幡市,70433,34030,36403
26,26211,京都府,京田辺市,73753,36111,37642
26,26212,京都府,京丹後市,50860,24357,26503
26,26213,京都府,南丹市,31629,15392,16237
26,26214,京都府,木津川市,77907,37295,40612
26,26303,京都府,大山崎町,15953,7710,8243
26,26322,京都府,久御山町,15250,7432,7818
26,26343,京都府,井手町,7406,3594,3812
26,26344,京都府,宇治田原町,8911,4501,4410
26,26364,京都府,笠置町,1144,541,603
26,26365,京都府,和束町,3478,1617,1861
26,26366,京都府,精華町,36198,17226,18972
26,26367,京都府,南山城村,2391,1125,1266
26,26407,京都府,京丹波町,12907,6113,6794
26,26463,京都府,伊根町,1928,946,982
26,26465,京都府,与謝野町,20092,9539,10553
27,27000,大阪府,大阪府,8837685,4235956,4601729
27,27100,大阪府,大阪市,2752412,1326875,1425537
27,27102,大阪府,大阪市都島区,107904,51763,56141
27,27103,大阪府,大阪市福島区,79328,37633,41695
27,27104,大阪府,大阪市此花区,65251,31610,33641
27,27106,大阪府,大阪市西区,105862,49586,56276
27,27107,大阪府,大阪市港区,80948,39498,41450
27,27108,大阪府,大阪市大正区,62083,30164,31919
27,27109,大阪府,大阪市天王寺区,82148,37988,44160
27,27111,大阪府,大阪市浪速区,75504,38393,37111
27,27113,大阪府,大阪市西淀川区,95864,47067,48797
27,27114,大阪府,大阪市東淀川区,177120,86660,90460
27,27115,大阪府,大阪市東成区,84906,40341,44565
27,27116,大阪府,大阪市生野区,127309,60309,67000
27,27117,大阪府,大阪市旭区,89670,42676,46994
27,27118,大阪府,大阪市城東区,169043,80220,88823
27,27119,大阪府,大阪市阿倍野区,110995,51160,59835
27,27120,大阪府,大阪市住吉区,153056,71193,81863
27,27121,大阪府,大阪市東住吉区,127849,60161,67688
27,27122,大阪府,大阪市西成区,106111,61300,44811
27,27123,大阪府,大阪市淀川区,183444,91327,92117
27,27124,大阪府,大阪市鶴見区,112691,53166,59525
27,27125,大阪府,大阪市住之江区,120072,57611,62461
27,27126,大阪府,大阪市平野区,192152,90568,101584
27,27127,大阪府,大阪市北区,139376,67805,71571
27,27128,大阪府,大阪市中央区,103726,48676,55050
27,27140,大阪府,堺市,826161,393961,432200
27,27141,大阪府,堺市堺区,148682,73620,75062
27,27142,大阪府,堺市中区,121236,58081,63155
27,27143,大阪府,堺市東区,85043,40398,44645
27,27144,大阪府,堺市西区,135375,64546,70829
27,27145,大阪府,堺市南区,138464,64156,74308
27,27146,大阪府,堺市北区,159757,75052,84705
27,27147,大阪府,堺市美原区,37604,18108,19496
27,27202,大阪府,岸和田市,190658,90424,100234
27,27203,大阪府,豊中市,401558,188931,212627
27,27204,大阪府,池田市,104993,49992,55001
27,27205,大阪府,吹田市,385567,185305,200262
27,27206,大阪府,泉大津市,74412,35224,39188
27,27207,大阪府,高槻市,352698,168081,184617
27,27208,大阪府,貝塚市,84443,40482,43961
27,27209,大阪府,守口市,143096,69204,73892
27,27210,大阪府,枚方市,397289,188191,209098
27,27211,大阪府,茨木市,287730,138658,149072
27,27212,大阪府,八尾市,264642,125858,138784
27,27213,大阪府,泉佐野市,100131,47828,52303
27,27214,大阪府,富田林市,108699,50919,57780
27,27215,大阪府,寝屋川市,229733,110807,118926
27,27216,大阪府,河内長野市,101692,47392,54300
27,27217,大阪府,松原市,117641,56535,61106
27,27218,大阪府,大東市,119367,57939,61428
27,27219,大阪府,和泉市,184495,88751,95744
27,27220,大阪府,箕面市,136868,64992,71876
27,27221,大阪府,柏原市,68775,32955,35820
27,27222,大阪府,羽曳野市,108736,51034,57702
27,27223,大阪府,門真市,119764,58772,60992
27,27224,大阪府,摂津市,87456,43166,44290
27,27225,大阪府,高石市,55635,26336,29299
27,27226,大阪府,藤井寺市,63688,29951,33737
27,27227,大阪府,東大阪市,493940,240288,253652
27,27228,大阪府,泉南市,60102,28718,31384
27,27229,大阪府,四條畷市,55177,26744,28433
27,27230,大阪府,交野市,75033,35805,39228
27,27231,大阪府,大阪狭山市,58435,27409,31026
27,27232,大阪府,阪南市,51254,24250,27004
27,27301,大阪府,島本町,30927,14604,16323
27,27321,大阪府,豊能町,18279,8676,9603
27,27322,大阪府,能勢町,9079,4361,4718
27,27341,大阪府,忠岡町,16567,7965,8602
27,27361,大阪府,熊取町,43763,21310,22453
27,27362,大阪府,田尻町,8434,4176,4258
27,27366,大阪府,岬町,14741,6816,7925
27,27381,大阪府,太子町,13009,6331,6678
27,27382,大阪府,河南町,15697,7621,8076
27,27383,大阪府,千早赤阪村,4909,2319,2590
28,28000,兵庫県,兵庫県,5465002,2599756,2865246
28,28100,兵庫県,神戸市,1525152,716452,808700
28,28101,兵庫県,神戸市東灘区,213562,99420,114142
28,28102,兵庫県,神戸市灘区,136747,63549,73198
28,28105,兵庫県,神戸市兵庫区,109144,52901,56243
28,28106,兵庫県,神戸市長田区,94791,44662,50129
28,28107,兵庫県,神戸市須磨区,158719,73064,85655
28,28108,兵庫県,神戸市垂水区,215302,100260,115042
28,28109,兵庫県,神戸市北区,210492,99465,111027
28,28110,兵庫県,神戸市中央区,147518,68236,79282
28,28111,兵庫県,神戸市西区,238877,114895,123982
28,28201,兵庫県,姫路市,530495,256616,273879
28,28202,兵庫県,尼崎市,459593,222293,237300
28,28203,兵庫県,明石市,303601,146746,156855
28,28204,兵庫県,西宮市,485587,226105,259482
28,28205,兵庫県,洲本市,41236,19635,21601
28,28206,兵庫県,芦屋市,93922,42008,51914
28,28207,兵庫県,伊丹市,198138,95630,102508
28,28208,兵庫県,相生市,28355,13592,14763
28,28209,兵庫県,豊岡市,77489,37303,40186
28,28210,兵庫県,加古川市,260878,127473,133405
28,28212,兵庫県,赤穂市,45892,22095,23797
28,28213,兵庫県,西脇市,38673,18540,20133
28,28214,兵庫県,宝塚市,226432,103655,122777
28,28215,兵庫県,三木市,75294,36259,39035
28,28216,兵庫県,高砂市,87722,42379,45343
28,28217,兵庫県,川西市,152321,71289,81032
28,28218,兵庫県,小野市,47562,23232,24330
28,28219,兵庫県,三田市,109238,52322,56916
28,28220,兵庫県,加西市,42700,21077,21623
28,28221,兵庫県,丹波篠山市,39611,18811,20800
28,28222,兵庫県,養父市,22129,10623,11506
28,28223,兵庫県,丹波市,61471,29464,32007
28,28224,兵庫県,南あわじ市,44137,21114,23023
28,28225,兵庫県,朝来市,28989,13893,15096
28,28226,兵庫県,淡路市,41967,19872,22095
28,28227,兵庫県,宍粟市,34819,16635,18184
28,28228,兵庫県,加東市,40645,19956,20689
28,28229,兵庫県,たつの市,74316,35918,38398
28,28301,兵庫県,猪名川町,29680,13975,15705
28,28365,兵庫県,多可町,19261,9311,9950
28,28381,兵庫県,稲美町,30268,14775,15493
28,28382,兵庫県,播磨町,33604,16332,17272
28,28442,兵庫県,市川町,11231,5482,5749
28,28443,兵庫県,福崎町,19377,9461,9916
28,28446,兵庫県,神河町,10616,4958,5658
28,28464,兵庫県,太子町,33477,16253,17224
28,28481,兵庫県,上郡町,13879,6717,7162
28,28501,兵庫県,佐用町,15863,7567,8296
28,28585,兵庫県,香美町,16064,7636,8428
28,28586,兵庫県,新温泉町,13318,6302,7016
29,29000,奈良県,奈良県,1324473,623926,700547
29,29201,奈良県,奈良市,354630,164846,189784
29,29202,奈良県,大和高田市,61744,28981,32763
29,29203,奈良県,大和郡山市,83285,39249,44036
29,29204,奈良県,天理市,63889,31275,32614
29,29205,奈良県,橿原市,120922,57336,63586
29,29206,奈良県,桜井市,54857,25909,28948
29,29207,奈良県,五條市,27927,13180,14747
29,29208,奈良県,御所市,24096,11122,12974
29,29209,奈良県,生駒市,116675,55107,61568
29,29210,奈良県,香芝市,78113,36925,41188
29,29211,奈良県,葛城市,36832,17526,19306
29,29212,奈良県,宇陀市,28121,13374,14747
29,29322,奈良県,山添村,3226,1543,1683
29,29342,奈良県,平群町,18009,8446,9563
29,29343,奈良県,三郷町,23219,10877,12342
29,29344,奈良県,斑鳩町,27587,12979,14608
29,29345,奈良県,安堵町,7225,3387,3838
29,29361,奈良県,川西町,8167,3944,4223
29,29362,奈良県,三宅町,6439,3049,3390
29,29363,奈良県,田原本町,31177,14870,16307
29,29385,奈良県,曽爾村,1295,595,700
29,29386,奈良県,御杖村,1479,694,785
29,29401,奈良県,高取町,6729,3139,3590
29,29402,奈良県,明日香村,5179,2439,2740
29,29424,奈良県,上牧町,21714,10117,11597
29,29425,奈良県,王寺町,24043,11375,12668
29,29426,奈良県,広陵町,33810,16045,17765
29,29427,奈良県,河合町,17018,7918,9100
29,29441,奈良県,吉野町,6229,2840,3389
29,29442,奈良県,大淀町,16728,7936,8792
29,29443,奈良県,下市町,5037,2356,2681
29,29444,奈良県,黒滝村,623,296,327
29,29446,奈良県,天川村,1176,567,609
29,29447,奈良県,野迫川村,357,176,181
29,29449,奈良県,十津川村,3061,1663,1398
29,29450,奈良県,下北山村,753,361,392
29,29451,奈良県,上北山村,444,227,217
29,29452,奈良県,川上村,1156,554,602
29,29453,奈良県,東吉野村,1502,703,799
30,30000,和歌山県,和歌山県,922584,435051,487533
30,30201,和歌山県,和歌山市,356729,167947,188782
30,30202,和歌山県,海南市,48369,22548,25821
30,30203,和歌山県,橋本市,60818,28621,32197
30,30204,和歌山県,有田市,26538,12576,13962
30,30205,和歌山県,御坊市,23481,11404,12077
30,30206,和歌山県,田辺市,69870,32790,37080
30,30207,和歌山県,新宮市,27171,12610,14561
30,30208,和歌山県,紀の川市,58816,27815,31001
30,30209,和歌山県,岩出市,53967,25969,27998
30,30304,和歌山県,紀美野町,8256,3796,4460
30,30341,和歌山県,かつらぎ町,15967,7428,8539
30,30343,和歌山県,九度山町,3856,1782,2074
30,30344,和歌山県,高野町,2970,1499,1471
30,30361,和歌山県,湯浅町,11122,5196,5926
30,30362,和歌山県,広川町,6781,3195,3586
30,30366,和歌山県,有田川町,25258,11953,13305
30,30381,和歌山県,美浜町,6867,3217,3650
30,30382,和歌山県,日高町,7673,3657,4016
30,30383,和歌山県,由良町,5364,2685,2679
30,30390,和歌山県,印南町,7720,3660,4060
30,30391,和歌山県,みなべ町,11818,5608,6210
30,30392,和歌山県,日高川町,9219,4449,4770
30,30401,和歌山県,白浜町,20262,9440,10822
30,30404,和歌山県,上富田町,15236,7246,7990
30,30406,和歌山県,すさみ町,3685,1747,1938
30,30421,和歌山県,那智勝浦町,14137,6531,7606
30,30422,和歌山県,太地町,2791,1229,1562
30,30424,和歌山県,古座川町,2480,1130,1350
30,30427,和歌山県,北山村,404,183,221
30,30428,和歌山県,串本町,14959,7140,7819
31,31000,鳥取県,鳥取県,553407,264432,288975
31,31201,鳥取県,鳥取市,188465,91356,97109
31,31202,鳥取県,米子市,147317,69740,77577
31,31203,鳥取県,倉吉市,46485,21840,24645
31,31204,鳥取県,境港市,32740,15775,16965
31,31302,鳥取県,岩美町,10799,5178,5621
31,31325,鳥取県,若桜町,2864,1355,1509
31,31328,鳥取県,智頭町,6427,3005,3422
31,31329,鳥取県,八頭町,15937,7611,8326
31,31364,鳥取県,三朝町,6060,2875,3185
31,31370,鳥取県,湯梨浜町,16055,7657,8398
31,31371,鳥取県,琴浦町,16365,7682,8683
31,31372,鳥取県,北栄町,14228,6818,7410
31,31384,鳥取県,日吉津村,3501,1628,1873
31,31386,鳥取県,大山町,15370,7390,7980
31,31389,鳥取県,南部町,10323,4925,5398
31,31390,鳥取県,伯耆町,10696,5051,5645
31,31401,鳥取県,日南町,4196,1982,2214
31,31402,鳥取県,日野町,2907,1323,1584
31,31403,鳥取県,江府町,2672,1241,1431
32,32000,島根県,島根県,671126,324291,346835
32,32201,島根県,松江市,203616,98544,105072
32,32202,島根県,浜田市,54592,27298,27294
32,32203,島根県,出雲市,172775,83469,89306
32,32204,島根県,益田市,45003,21355,23648
32,32205,島根県,大田市,32846,15742,17104
32,32206,島根県,安来市,37062,17743,19319
32,32207,島根県,江津市,22959,10890,12069
32,32209,島根県,雲南市,36007,17316,18691
32,32343,島根県,奥出雲町,11849,5705,6144
32,32386,島根県,飯南町,4577,2157,2420
32,32441,島根県,川本町,3248,1556,1692
32,32448,島根県,美郷町,4355,2080,2275
32,32449,島根県,邑南町,10163,4874,5289
32,32501,島根県,津和野町,6875,3221,3654
32,32505,島根県,吉賀町,6077,2944,3133
32,32525,島根県,海士町,2267,1113,1154
32,32526,島根県,西ノ島町,2788,1430,1358
32,32527,島根県,知夫村,634,323,311
32,32528,島根県,隠岐の島町,13433,6531,6902
33,33000,岡山県,岡山県,1888432,908045,980387
33,33100,岡山県,岡山市,724691,348630,376061
33,33101,岡山県,岡山市北区,314523,153478,161045
33,33102,岡山県,岡山市中区,149232,70139,79093
33,33103,岡山県,岡山市東区,93108,44243,48865
33,33104,岡山県,岡山市南区,167828,80770,87058
33,33202,岡山県,倉敷市,474592,228261,246331
33,33203,岡山県,津山市,99937,48012,51925
33,33204,岡山県,玉野市,56531,27437,29094
33,33205,岡山県,笠岡市,46088,21866,24222
33,33207,岡山県,井原市,38384,18353,20031
33,33208,岡山県,総社市,69030,33425,35605
33,33209,岡山県,高梁市,29072,14225,14847
33,33210,岡山県,新見市,28079,13411,14668
33,33211,岡山県,備前市,32320,15516,16804
33,33212,岡山県,瀬戸内市,36048,17319,18729
33,33213,岡山県,赤磐市,42661,20454,22207
33,33214,岡山県,真庭市,42725,20397,22328
33,33215,岡山県,美作市,25939,12452,13487
33,33216,岡山県,浅口市,32772,15760,17012
33,33346,岡山県,和気町,13623,6468,7155
33,33423,岡山県,早島町,12368,5930,6438
33,33445,岡山県,里庄町,10950,5206,5744
33,33461,岡山県,矢掛町,13414,6412,7002
33,33586,岡山県,新庄村,813,380,433
33,33606,岡山県,鏡野町,12062,5810,6252
33,33622,岡山県,勝央町,10888,5204,5684
33,33623,岡山県,奈義町,5578,2788,2790
33,33643,岡山県,西粟倉村,1398,651,747
33,33663,岡山県,久米南町,4530,2173,2357
33,33666,岡山県,美咲町,13053,6230,6823
33,33681,岡山県,吉備中央町,10886,5275,5611
34,34000,広島県,広島県,2799702,1357156,1442546
34,34100,広島県,広島市,1200754,579415,621339
34,34101,広島県,広島市中区,142699,67660,75039
34,34102,広島県,広島市東区,119353,56872,62481
34,34103,広島県,広島市南区,145805,71544,74261
34,34104,広島県,広島市西区,190232,91127,99105
34,34105,広島県,広島市安佐南区,247020,120308,126712
34,34106,広島県,広島市安佐北区,138979,65972,73007
34,34107,広島県,広島市安芸区,77103,38283,38820
34,34108,広島県,広島市佐伯区,139563,67649,71914
34,34202,広島県,呉市,214592,103816,110776
34,34203,広島県,竹原市,23993,11434,12559
34,34204,広島県,三原市,90573,43155,47418
34,34205,広島県,尾道市,131170,63468,67702
34,34207,広島県,福山市,460930,224246,236684
34,34208,広島県,府中市,37655,18115,19540
34,34209,広島県,三次市,50681,24220,26461
34,34210,広島県,庄原市,33633,16014,17619
34,34211,広島県,大竹市,26319,12820,13499
34,34212,広島県,東広島市,196608,99690,96918
34,34213,広島県,廿日市市,114173,54393,59780
34,34214,広島県,安芸高田市,26448,12614,13834
34,34215,広島県,江田島市,21930,11025,10905
34,34302,広島県,府中町,51155,25007,26148
34,34304,広島県,海田町,29636,14588,15048
34,34307,広島県,熊野町,22834,10958,11876
34,34309,広島県,坂町,12582,5984,6598
34,34368,広島県,安芸太田町,5740,2675,3065
34,34369,広島県,北広島町,17763,8768,8995
34,34431,広島県,大崎上島町,7158,3663,3495
34,34462,広島県,世羅町,15125,7156,7969
34,34545,広島県,神石高原町,8250,3932,4318
35,35000,山口県,山口県,1342059,636736,705323
35,35201,山口県,下関市,255051,118683,136368
35,35202,山口県,宇部市,162570,77793,84777
35,35203,山口県,山口市,193966,92352,101614
35,35204,山口県,萩市,44626,20610,24016
35,35206,山口県,防府市,113979,54951,59028
35,35207,山口県,下松市,55887,27405,28482
35,35208,山口県,岩国市,129125,60981,68144
35,35210,山口県,光市,49798,23711,26087
35,35211,山口県,長門市,32519,15040,17479
35,35212,山口県,柳井市,30799,14345,16454
35,35213,山口県,美祢市,23247,10857,12390
35,35215,山口県,周南市,137540,66686,70854
35,35216,山口県,山陽小野田市,60326,28635,31691
35,35305,山口県,周防大島町,14798,6828,7970
35,35321,山口県,和木町,6034,2947,3087
35,35341,山口県,上関町,2342,1084,1258
35,35343,山口県,田布施町,14483,6908,7575
35,35344,山口県,平生町,11914,5553,6361
35,35502,山口県,阿武町,3055,1367,1688
36,36000,徳島県,徳島県,719559,343265,376294
36,36201,徳島県,徳島市,252391,120188,132203
36,36202,徳島県,鳴門市,54622,25858,28764
36,36203,徳島県,小松島市,36149,17461,18688
36,36204,徳島県,阿南市,69470,33694,35776
36,36205,徳島県,吉野川市,38772,18231,20541
36,36206,徳島県,阿波市,34713,16476,18237
36,36207,徳島県,美馬市,28055,13342,14713
36,36208,徳島県,三好市,23605,11117,12488
36,36301,徳島県,勝浦町,4837,2317,2520
36,36302,徳島県,上勝町,1380,651,729
36,36321,徳島県,佐那河内村,2058,998,1060
36,36341,徳島県,石井町,24833,11752,13081
36,36342,徳島県,神山町,4647,2183,2464
36,36368,徳島県,那賀町,7367,3521,3846
36,36383,徳島県,牟岐町,3743,1735,2008
36,36387,徳島県,美波町,6222,2923,3299
36,36388,徳島県,海陽町,8358,3965,4393
36,36401,徳島県,松茂町,14583,7193,7390
36,36402,徳島県,北島町,22745,10976,11769
36,36403,徳島県,藍住町,35246,16868,18378
36,36404,徳島県,板野町,13042,6262,6780
36,36405,徳島県,上板町,11384,5431,5953
36,36468,徳島県,つるぎ町,7715,3608,4107
36,36489,徳島県,東みよし町,13622,6515,7107
37,37000,香川県,香川県,950244,459197,491047
37,37201,香川県,高松市,417496,202029,215467
37,37202,香川県,丸亀市,109513,53018,56495
37,37203,香川県,坂出市,50624,24145,26479
37,37204,香川県,善通寺市,31631,15725,15906
37,37205,香川県,観音寺市,57438,27578,29860
37,37206,香川県,さぬき市,47003,22484,24519
37,37207,香川県,東かがわ市,28279,13358,14921
37,37208,香川県,三豊市,61857,29770,32087
37,37322,香川県,土庄町,12846,6044,6802
37,37324,香川県,小豆島町,13870,6621,7249
37,37341,香川県,三木町,26878,12943,13935
37,37364,香川県,直島町,3103,1646,1457
37,37386,香川県,宇多津町,18699,9180,9519
37,37387,香川県,綾川町,22693,10999,11694
37,37403,香川県,琴平町,8468,3938,4530
37,37404,香川県,多度津町,22445,11373,11072
37,37406,香川県,まんのう町,17401,8346,9055
38,38000,愛媛県,愛媛県,1334841,633062,701779
38,38201,愛媛県,松山市,511192,240292,270900
38,38202,愛媛県,今治市,151672,71799,79873
38,38203,愛媛県,宇和島市,70809,33213,37596
38,38204,愛媛県,八幡浜市,31987,14971,17016
38,38205,愛媛県,新居浜市,115938,56004,59934
38,38206,愛媛県,西条市,104791,50615,54176
38,38207,愛媛県,大洲市,40575,19423,21152
38,38210,愛媛県,伊予市,35133,16385,18748
38,38213,愛媛県,四国中央市,82754,40468,42286
38,38214,愛媛県,西予市,35388,16635,18753
38,38215,愛媛県,東温市,33903,16180,17723
38,38356,愛媛県,上島町,6509,3421,3088
38,38386,愛媛県,久万高原町,7404,3513,3891
38,38401,愛媛県,松前町,29630,13911,15719
38,38402,愛媛県,砥部町,20480,9519,10961
38,38422,愛媛県,内子町,15322,7303,8019
38,38442,愛媛県,伊方町,8397,4036,4361
38,38484,愛媛県,松野町,3674,1725,1949
38,38488,愛媛県,鬼北町,9682,4463,5219
38,38506,愛媛県,愛南町,19601,9186,10415
39,39000,高知県,高知県,691527,326531,364996
39,39201,高知県,高知市,326545,152455,174090
39,39202,高知県,室戸市,11742,5648,6094
39,39203,高知県,安芸市,16243,7754,8489
39,39204,高知県,南国市,46664,22130,24534
39,39205,高知県,土佐市,25732,12384,13348
39,39206,高知県,須崎市,20590,10068,10522
39,39208,高知県,宿毛市,19033,8914,10119
39,39209,高知県,土佐清水市,12388,5842,6546
39,39210,高知県,四万十市,32694,15455,17239
39,39211,高知県,香南市,32207,15545,16662
39,39212,高知県,香美市,26513,12848,13665
39,39301,高知県,東洋町,2194,1085,1109
39,39302,高知県,奈半利町,3034,1399,1635
39,39303,高知県,田野町,2498,1174,1324
39,39304,高知県,安田町,2370,1144,1226
39,39305,高知県,北川村,1146,552,594
39,39306,高知県,馬路村,745,358,387
39,39307,高知県,芸西村,3694,1724,1970
39,39341,高知県,本山町,3261,1516,1745
39,39344,高知県,大豊町,3252,1546,1706
39,39363,高知県,土佐町,3753,1780,1973
39,39364,高知県,大川村,366,189,177
39,39386,高知県,いの町,21374,10179,11195
39,39387,高知県,仁淀川町,4827,2306,2521
39,39401,高知県,中土佐町,6002,2782,3220
39,39402,高知県,佐川町,12323,5751,6572
39,39403,高知県,越知町,5187,2390,2797
39,39405,高知県,檮原町,3307,1611,1696
39,39410,高知県,日高村,4812,2282,2530
39,39411,高知県,津野町,5291,2516,2775
39,39412,高知県,四万十町,15607,7442,8165
39,39424,高知県,大月町,4434,2128,2306
39,39427,高知県,三原村,1437,690,747
39,39428,高知県,黒潮町,10262,4944,5318
40,40000,福岡県,福岡県,5135214,2430951,2704263
40,40100,福岡県,北九州市,939029,443269,495760
40,40101,福岡県,北九州市門司区,93842,43051,50791
40,40103,福岡県,北九州市若松区,80533,38307,42226
40,40105,福岡県,北九州市戸畑区,57494,28038,29456
40,40106,福岡県,北九州市小倉北区,183407,86089,97318
40,40107,福岡県,北九州市小倉南区,209028,99584,109444
40,40108,福岡県,北九州市八幡東区,64792,30400,34392
40,40109,福岡県,北九州市八幡西区,249933,117800,132133
40,40130,福岡県,福岡市,1612392,761148,851244
40,40131,福岡県,福岡市東区,322503,156725,165778
40,40132,福岡県,福岡市博多区,252034,121654,130380
40,40133,福岡県,福岡市中央区,205501,92450,113051
40,40134,福岡県,福岡市南区,265583,122925,142658
40,40135,福岡県,福岡市西区,212579,100887,111692
40,40136,福岡県,福岡市城南区,132864,62325,70539
40,40137,福岡県,福岡市早良区,221328,104182,117146
40,40202,福岡県,大牟田市,111281,51262,60019
40,40203,福岡県,久留米市,303316,144522,158794
40,40204,福岡県,直方市,56212,26403,29809
40,40205,福岡県,飯塚市,126364,60174,66190
40,40206,福岡県,田川市,46203,21056,25147
40,40207,福岡県,柳川市,64475,30437,34038
40,40210,福岡県,八女市,60608,28451,32157
40,40211,福岡県,筑後市,48827,23400,25427
40,40212,福岡県,大川市,32988,15427,17561
40,40213,福岡県,行橋市,71426,34120,37306
40,40214,福岡県,豊前市,24391,11378,13013
40,40215,福岡県,中間市,40362,18961,21401
40,40216,福岡県,小郡市,59360,27825,31535
40,40217,福岡県,筑紫野市,103311,49289,54022
40,40218,福岡県,春日市,111023,53099,57924
40,40219,福岡県,大野城市,102085,48887,53198
40,40220,福岡県,宗像市,97095,46143,50952
40,40221,福岡県,太宰府市,73164,34743,38421
40,40223,福岡県,古賀市,58786,27924,30862
40,40224,福岡県,福津市,67033,31286,35747
40,40225,福岡県,うきは市,27981,13145,14836
40,40226,福岡県,宮若市,26298,12379,13919
40,40227,福岡県,嘉麻市,35473,16400,19073
40,40228,福岡県,朝倉市,50273,23546,26727
40,40229,福岡県,みやま市,35861,16675,19186
40,40230,福岡県,糸島市,98877,46984,51893
40,40231,福岡県,那珂川市,50112,24194,25918
40,40341,福岡県,宇美町,37671,18964,18707
40,40342,福岡県,篠栗町,31209,15014,16195
40,40343,福岡県,志免町,46377,22291,24086
40,40344,福岡県,須恵町,28628,13760,14868
40,40345,福岡県,新宮町,32927,15894,17033
40,40348,福岡県,久山町,9068,4281,4787
40,40349,福岡県,粕屋町,48190,23840,24350
40,40381,福岡県,芦屋町,13545,6629,6916
40,40382,福岡県,水巻町,28114,13074,15040
40,40383,福岡県,岡垣町,31007,14481,16526
40,40384,福岡県,遠賀町,18723,8795,9928
40,40401,福岡県,小竹町,7151,3406,3745
40,40402,福岡県,鞍手町,15080,7074,8006
40,40421,福岡県,桂川町,12878,6018,6860
40,40447,福岡県,筑前町,29591,14061,15530
40,40448,福岡県,東峰村,1899,868,1031
40,40503,福岡県,大刀洗町,15521,7438,8083
40,40522,福岡県,大木町,13820,6545,7275
40,40544,福岡県,広川町,19969,9589,10380
40,40601,福岡県,香春町,10191,4737,5454
40,40602,福岡県,添田町,8801,4128,4673
40,40604,福岡県,糸田町,8407,3843,4564
40,40605,福岡県,川崎町,15176,6918,8258
40,40608,福岡県,大任町,5008,2262,2746
40,40609,福岡県,赤村,2774,1295,1479
40,40610,福岡県,福智町,21398,9984,11414
40,40621,福岡県,苅田町,37684,19639,18045
40,40625,福岡県,みやこ町,18825,8803,10022
40,40642,福岡県,吉富町,6536,3068,3468
40,40646,福岡県,上毛町,7251,3453,3798
40,40647,福岡県,築上町,17189,8272,8917
41,41000,佐賀県,佐賀県,811442,384451,426991
41,41201,佐賀県,佐賀市,233301,110191,123110
41,41202,佐賀県,唐津市,117373,55015,62358
41,41203,佐賀県,鳥栖市,74196,35528,38668
41,41204,佐賀県,多久市,18295,8555,9740
41,41205,佐賀県,伊万里市,52629,25445,27184
41,41206,佐賀県,武雄市,47914,22727,25187
41,41207,佐賀県,鹿島市,27892,13140,14752
41,41208,佐賀県,小城市,43952,20772,23180
41,41209,佐賀県,嬉野市,25848,11995,13853
41,41210,佐賀県,神埼市,31022,14884,16138
41,41327,佐賀県,吉野ヶ里町,16323,7990,8333
41,41341,佐賀県,基山町,17250,8174,9076
41,41345,佐賀県,上峰町,9286,4455,4831
41,41346,佐賀県,みやき町,25511,12170,13341
41,41387,佐賀県,玄海町,5609,3067,2542
41,41401,佐賀県,有田町,19010,8780,10230
41,41423,佐賀県,大町町,6293,2903,3390
41,41424,佐賀県,江北町,9566,4460,5106
41,41425,佐賀県,白石町,22051,10358,11693
41,41441,佐賀県,太良町,8121,3842,4279
42,42000,長崎県,長崎県,1312317,616912,695405
42,42201,長崎県,長崎市,409118,188519,220599
42,42202,長崎県,佐世保市,243223,115131,128092
42,42203,長崎県,島原市,43338,20157,23181
42,42204,長崎県,諫早市,133852,63544,70308
42,42205,長崎県,大村市,95397,45448,49949
42,42207,長崎県,平戸市,29365,13771,15594
42,42208,長崎県,松浦市,21271,10278,10993
42,42209,長崎県,対馬市,28502,14060,14442
42,42210,長崎県,壱岐市,24948,11837,13111
42,42211,長崎県,五島市,34391,16141,18250
42,42212,長崎県,西海市,26275,13120,13155
42,42213,長崎県,雲仙市,41096,19378,21718
42,42214,長崎県,南島原市,42330,19598,22732
42,42307,長崎県,長与町,40780,19196,21584
42,42308,長崎県,時津町,29339,14116,15223
42,42321,長崎県,東彼杵町,7721,3686,4035
42,42322,長崎県,川棚町,13377,6300,7077
42,42323,長崎県,波佐見町,14291,6753,7538
42,42383,長崎県,小値賀町,2288,1054,1234
42,42391,長崎県,佐々町,13912,6591,7321
42,42411,長崎県,新上五島町,17503,8234,9269
43,43000,熊本県,熊本県,1738301,822481,915820
43,43100,熊本県,熊本市,738865,349115,389750
43,43101,熊本県,熊本市中央区,187502,88508,98994
43,43102,熊本県,熊本市東区,189524,89763,99761
43,43103,熊本県,熊本市西区,91177,42796,48381
43,43104,熊本県,熊本市南区,130829,61632,69197
43,43105,熊本県,熊本市北区,139833,66416,73417
43,43202,熊本県,八代市,123067,57298,65769
43,43203,熊本県,人吉市,31108,14363,16745
43,43204,熊本県,荒尾市,50832,23900,26932
43,43205,熊本県,水俣市,23557,10913,12644
43,43206,熊本県,玉名市,64292,30410,33882
43,43208,熊本県,山鹿市,49025,23000,26025
43,43210,熊本県,菊池市,46416,22076,24340
43,43211,熊本県,宇土市,36122,17272,18850
43,43212,熊本県,上天草市,24563,11502,13061
43,43213,熊本県,宇城市,57032,26991,30041
43,43214,熊本県,阿蘇市,24930,11763,13167
43,43215,熊本県,天草市,75783,35420,40363
43,43216,熊本県,合志市,61772,29702,32070
43,43348,熊本県,美里町,9392,4361,5031
43,43364,熊本県,玉東町,5045,2399,2646
43,43367,熊本県,南関町,8979,4282,4697
43,43368,熊本県,長洲町,15372,7668,7704
43,43369,熊本県,和水町,9342,4397,4945
43,43403,熊本県,大津町,35187,17449,17738
43,43404,熊本県,菊陽町,43337,21220,22117
43,43423,熊本県,南小国町,3750,1781,1969
43,43424,熊本県,小国町,6590,3135,3455
43,43425,熊本県,産山村,1382,714,668
43,43428,熊本県,高森町,5789,2788,3001
43,43432,熊本県,西原村,6426,3109,3317
43,43433,熊本県,南阿蘇村,9836,4796,5040
43,43441,熊本県,御船町,16303,7762,8541
43,43442,熊本県,嘉島町,9547,4584,4963
43,43443,熊本県,益城町,32510,15602,16908
43,43444,熊本県,甲佐町,10132,4813,5319
43,43447,熊本県,山都町,13503,6439,7064
43,43468,熊本県,氷川町,11094,5083,6011
43,43482,熊本県,芦北町,15681,7370,8311
43,43484,熊本県,津奈木町,4254,1993,2261
43,43501,熊本県,錦町,10288,4891,5397
43,43505,熊本県,多良木町,9076,4263,4813
43,43506,熊本県,湯前町,3627,1700,1927
43,43507,熊本県,水上村,2033,938,1095
43,43510,熊本県,相良村,4070,1929,2141
43,43511,熊本県,五木村,931,447,484
43,43512,熊本県,山江村,3238,1498,1740
43,43513,熊本県,球磨村,2433,1174,1259
43,43514,熊本県,あさぎり町,14676,6783,7893
43,43531,熊本県,苓北町,7114,3388,3726
44,44000,大分県,大分県,1123852,533414,590438
44,44201,大分県,大分市,475614,228421,247193
44,44202,大分県,別府市,115321,52398,62923
44,44203,大分県,中津市,82863,40307,42556
44,44204,大分県,日田市,62657,29676,32981
44,44205,大分県,佐伯市,66851,30885,35966
44,44206,大分県,臼杵市,36158,17093,19065
44,44207,大分県,津久見市,16100,7499,8601
44,44208,大分県,竹田市,20332,9506,10826
44,44209,大分県,豊後高田市,22112,10498,11614
44,44210,大分県,杵築市,27999,13437,14562
44,44211,大分県,宇佐市,52771,24882,27889
44,44212,大分県,豊後大野市,33695,15699,17996
44,44213,大分県,由布市,32772,15599,17173
44,44214,大分県,国東市,26232,12504,13728
44,44322,大分県,姫島村,1725,804,921
44,44341,大分県,日出町,27723,13230,14493
44,44461,大分県,九重町,8541,4036,4505
44,44462,大分県,玖珠町,14386,6940,7446
45,45000,宮崎県,宮崎県,1069576,504763,564813
45,45201,宮崎県,宮崎市,401339,189342,211997
45,45202,宮崎県,都城市,160640,75308,85332
45,45203,宮崎県,延岡市,118394,56100,62294
45,45204,宮崎県,日南市,50848,23930,26918
45,45205,宮崎県,小林市,43670,20327,23343
45,45206,宮崎県,日向市,59629,28372,31257
45,45207,宮崎県,串間市,16822,7876,8946
45,45208,宮崎県,西都市,28610,13423,15187
45,45209,宮崎県,えびの市,17638,8339,9299
45,45341,宮崎県,三股町,25591,11932,13659
45,45361,宮崎県,高原町,8639,4127,4512
45,45382,宮崎県,国富町,18398,8609,9789
45,45383,宮崎県,綾町,6934,3267,3667
45,45401,宮崎県,高鍋町,19922,9497,10425
45,45402,宮崎県,新富町,16564,8096,8468
45,45403,宮崎県,西米良村,1000,492,508
45,45404,宮崎県,木城町,4895,2250,2645
45,45405,宮崎県,川南町,15194,7147,8047
45,45406,宮崎県,都農町,9906,4677,5229
45,45421,宮崎県,門川町,17379,8276,9103
45,45429,宮崎県,諸塚村,1486,725,761
45,45430,宮崎県,椎葉村,2503,1268,1235
45,45431,宮崎県,美郷町,4826,2337,2489
45,45441,宮崎県,高千穂町,11642,5604,6038
45,45442,宮崎県,日之影町,3635,1745,1890
45,45443,宮崎県,五ヶ瀬町,3472,1697,1775
46,46000,鹿児島県,鹿児島県,1588256,748306,839950
46,46201,鹿児島県,鹿児島市,593128,276130,316998
46,46203,鹿児島県,鹿屋市,101096,48390,52706
46,46204,鹿児島県,枕崎市,20033,9178,10855
46,46206,鹿児島県,阿久根市,19270,9064,10206
46,46208,鹿児島県,出水市,51994,24237,27757
46,46210,鹿児島県,指宿市,39011,18107,20904
46,46213,鹿児島県,西之表市,14708,7049,7659
46,46214,鹿児島県,垂水市,13819,6397,7422
46,46215,鹿児島県,薩摩川内市,92403,44570,47833
46,46216,鹿児島県,日置市,47153,22167,24986
46,46217,鹿児島県,曽於市,33310,15556,17754
46,46218,鹿児島県,霧島市,123135,58976,64159
46,46219,鹿児島県,いちき串木野市,27490,12742,14748
46,46220,鹿児島県,南さつま市,32887,15107,17780
46,46221,鹿児島県,志布志市,29329,13998,15331
46,46222,鹿児島県,奄美市,41390,19778,21612
46,46223,鹿児島県,南九州市,33080,15447,17633
46,46224,鹿児島県,伊佐市,24453,11327,13126
46,46225,鹿児島県,姶良市,76348,35748,40600
46,46303,鹿児島県,三島村,405,191,214
46,46304,鹿児島県,十島村,740,412,328
46,46392,鹿児島県,さつま町,20243,9439,10804
46,46404,鹿児島県,長島町,9705,4706,4999
46,46452,鹿児島県,湧水町,9119,4403,4716
46,46468,鹿児島県,大崎町,12385,5868,6517
46,46482,鹿児島県,東串良町,6237,2946,3291
46,46490,鹿児島県,錦江町,6944,3259,3685
46,46491,鹿児島県,南大隅町,6481,3078,3403
46,46492,鹿児島県,肝付町,14227,6982,7245
46,46501,鹿児島県,中種子町,7539,3549,3990
46,46502,鹿児島県,南種子町,5445,2726,2719
46,46505,鹿児島県,屋久島町,11858,5800,6058
46,46523,鹿児島県,大和村,1364,673,691
46,46524,鹿児島県,宇検村,1621,792,829
46,46525,鹿児島県,瀬戸内町,8546,4215,4331
46,46527,鹿児島県,龍郷町,5817,2812,3005
46,46529,鹿児島県,喜界町,6629,3255,3374
46,46530,鹿児島県,徳之島町,10147,4967,5180
46,46531,鹿児島県,天城町,5517,2788,2729
46,46532,鹿児島県,伊仙町,6139,3074,3065
46,46533,鹿児島県,和泊町,6246,3081,3165
46,46534,鹿児島県,知名町,5750,2862,2888
46,46535,鹿児島県,与論町,5115,2460,2655
47,47000,沖縄県,沖縄県,1467480,722812,744668
47,47201,沖縄県,那覇市,317625,154042,163583
47,47205,沖縄県,宜野湾市,100125,48826,51299
47,47207,沖縄県,石垣市,47637,24001,23636
47,47208,沖縄県,浦添市,115690,55977,59713
47,47209,沖縄県,名護市,63554,31606,31948
47,47210,沖縄県,糸満市,61007,30707,30300
47,47211,沖縄県,沖縄市,142752,69489,73263
47,47212,沖縄県,豊見城市,64612,31465,33147
47,47213,沖縄県,うるま市,125303,63049,62254
47,47214,沖縄県,宮古島市,52931,26481,26450
47,47215,沖縄県,南城市,44043,22164,21879
47,47301,沖縄県,国頭村,4517,2317,2200
47,47302,沖縄県,大宜味村,3092,1640,1452
47,47303,沖縄県,東村,1598,884,714
47,47306,沖縄県,今帰仁村,8894,4466,4428
47,47308,沖縄県,本部町,12530,6337,6193
47,47311,沖縄県,恩納村,10869,5497,5372
47,47313,沖縄県,宜野座村,5833,2907,2926
47,47314,沖縄県,金武町,10806,5371,5435
47,47315,沖縄県,伊江村,4118,2074,2044
47,47324,沖縄県,読谷村,41206,20242,20964
47,47325,沖縄県,嘉手納町,13521,6561,6960
47,47326,沖縄県,北谷町,28201,13483,14718
47,47327,沖縄県,北中城村,17969,8667,9302
47,47328,沖縄県,中城村,22157,11036,11121
47,47329,沖縄県,西原町,34984,17647,17337
47,47348,沖縄県,与那原町,19695,9554,10141
47,47350,沖縄県,南風原町,40440,19825,20615
47,47353,沖縄県,渡嘉敷村,718,387,331
47,47354,沖縄県,座間味村,892,486,406
47,47355,沖縄県,粟国村,683,384,299
47,47356,沖縄県,渡名喜村,346,206,140
47,47357,沖縄県,南大東村,1285,744,541
47,47358,沖縄県,北大東村,590,367,223
47,47359,沖縄県,伊平屋村,1126,607,519
47,47360,沖縄県,伊是名村,1322,718,604
47,47361,沖縄県,久米島町,7192,3823,3369
47,47362,沖縄県,八重瀬町,30941,15244,15697
47,47375,沖縄県,多良間村,1058,575,483
47,47381,沖縄県,竹富町,3942,2033,1909
47,47382,沖縄県,与那国町,1676,923,753
